Rk,Date,Tm,,Opp,Result,MP,FG,FGA,FG%,2P,2PA,2P%,3P,3PA,3P%,FT,FTA,FT%,PTS,FG,FGA,FG%,2P,2PA,2P%,3P,3PA,3P%,FT,FTA,FT%,PTS
1,2021-10-19,GSW,@,LAL,W 121-114,240,41,93,.441,27,54,.500,14,39,.359,25,30,.833,121,45,95,.474,30,53,.566,15,42,.357,9,19,.474,114
2,2021-10-19,LAL,,GSW,L 114-121,240,45,95,.474,30,53,.566,15,42,.357,9,19,.474,114,41,93,.441,27,54,.500,14,39,.359,25,30,.833,121
3,2021-10-19,BRK,@,MIL,L 104-127,240,37,84,.440,20,52,.385,17,32,.531,13,23,.565,104,48,105,.457,31,60,.517,17,45,.378,14,18,.778,127
4,2021-10-19,MIL,,BRK,W 127-104,240,48,105,.457,31,60,.517,17,45,.378,14,18,.778,127,37,84,.440,20,52,.385,17,32,.531,13,23,.565,104
5,2021-10-20,CHO,,IND,W 123-122,240,46,107,.430,33,76,.434,13,31,.419,18,27,.667,123,42,90,.467,25,43,.581,17,47,.362,21,24,.875,122
6,2021-10-20,IND,@,CHO,L 122-123,240,42,90,.467,25,43,.581,17,47,.362,21,24,.875,122,46,107,.430,33,76,.434,13,31,.419,18,27,.667,123
7,2021-10-20,CHI,@,DET,W 94-88,240,37,86,.430,30,63,.476,7,23,.304,13,15,.867,94,36,90,.400,30,62,.484,6,28,.214,10,13,.769,88
8,2021-10-20,DET,,CHI,L 88-94,240,36,90,.400,30,62,.484,6,28,.214,10,13,.769,88,37,86,.430,30,63,.476,7,23,.304,13,15,.867,94
9,2021-10-20,CLE,@,MEM,L 121-132,240,47,93,.505,33,55,.600,14,38,.368,13,18,.722,121,53,100,.530,39,67,.582,14,33,.424,12,12,1.000,132
10,2021-10-20,MEM,,CLE,W 132-121,240,53,100,.530,39,67,.582,14,33,.424,12,12,1.000,132,47,93,.505,33,55,.600,14,38,.368,13,18,.722,121
11,2021-10-20,HOU,@,MIN,L 106-124,240,40,88,.455,29,55,.527,11,33,.333,15,22,.682,106,42,87,.483,26,49,.531,16,38,.421,24,31,.774,124
12,2021-10-20,MIN,,HOU,W 124-106,240,42,87,.483,26,49,.531,16,38,.421,24,31,.774,124,40,88,.455,29,55,.527,11,33,.333,15,22,.682,106
13,2021-10-20,NOP,,PHI,L 97-117,240,39,93,.419,26,63,.413,13,30,.433,6,9,.667,97,44,85,.518,31,60,.517,13,25,.520,16,20,.800,117
14,2021-10-20,PHI,@,NOP,W 117-97,240,44,85,.518,31,60,.517,13,25,.520,16,20,.800,117,39,93,.419,26,63,.413,13,30,.433,6,9,.667,97
15,2021-10-20,BOS,@,NYK,L 134-138 (2OT),290,48,117,.410,27,60,.450,21,57,.368,17,23,.739,134,51,105,.486,34,60,.567,17,45,.378,19,27,.704,138
16,2021-10-20,NYK,,BOS,W 138-134 (2OT),290,51,105,.486,34,60,.567,17,45,.378,19,27,.704,138,48,117,.410,27,60,.450,21,57,.368,17,23,.739,134
17,2021-10-20,DEN,@,PHO,W 110-98,240,44,83,.530,27,44,.614,17,39,.436,5,9,.556,110,36,87,.414,22,50,.440,14,37,.378,12,17,.706,98
18,2021-10-20,PHO,,DEN,L 98-110,240,36,87,.414,22,50,.440,14,37,.378,12,17,.706,98,44,83,.530,27,44,.614,17,39,.436,5,9,.556,110
19,2021-10-20,POR,,SAC,L 121-124,240,45,93,.484,33,58,.569,12,35,.343,19,22,.864,121,42,92,.457,25,51,.490,17,41,.415,23,29,.793,124
20,2021-10-20,SAC,@,POR,W 124-121,240,42,92,.457,25,51,.490,17,41,.415,23,29,.793,124,45,93,.484,33,58,.569,12,35,.343,19,22,.864,121
21,2021-10-20,ORL,@,SAS,L 97-123,240,35,86,.407,26,57,.456,9,29,.310,18,23,.783,97,49,98,.500,36,68,.529,13,30,.433,12,18,.667,123
22,2021-10-20,SAS,,ORL,W 123-97,240,49,98,.500,36,68,.529,13,30,.433,12,18,.667,123,35,86,.407,26,57,.456,9,29,.310,18,23,.783,97
23,2021-10-20,TOR,,WAS,L 83-98,240,30,97,.309,23,63,.365,7,34,.206,16,22,.727,83,36,81,.444,31,54,.574,5,27,.185,21,26,.808,98
24,2021-10-20,WAS,@,TOR,W 98-83,240,36,81,.444,31,54,.574,5,27,.185,21,26,.808,98,30,97,.309,23,63,.365,7,34,.206,16,22,.727,83
25,2021-10-20,OKC,@,UTA,L 86-107,240,34,91,.374,27,56,.482,7,35,.200,11,18,.611,86,40,91,.440,26,44,.591,14,47,.298,13,15,.867,107
26,2021-10-20,UTA,,OKC,W 107-86,240,40,91,.440,26,44,.591,14,47,.298,13,15,.867,107,34,91,.374,27,56,.482,7,35,.200,11,18,.611,86
27,2021-10-21,ATL,,DAL,W 113-87,240,45,94,.479,30,59,.508,15,35,.429,8,9,.889,113,31,93,.333,18,50,.360,13,43,.302,12,13,.923,87
28,2021-10-21,DAL,@,ATL,L 87-113,240,31,93,.333,18,50,.360,13,43,.302,12,13,.923,87,45,94,.479,30,59,.508,15,35,.429,8,9,.889,113
29,2021-10-21,GSW,,LAC,W 115-113,240,43,83,.518,28,52,.538,15,31,.484,14,22,.636,115,42,96,.438,28,56,.500,14,40,.350,15,21,.714,113
30,2021-10-21,LAC,@,GSW,L 113-115,240,42,96,.438,28,56,.500,14,40,.350,15,21,.714,113,43,83,.518,28,52,.538,15,31,.484,14,22,.636,115
31,2021-10-21,MIA,,MIL,W 137-95,240,51,96,.531,36,61,.590,15,35,.429,20,31,.645,137,32,84,.381,20,42,.476,12,42,.286,19,29,.655,95
32,2021-10-21,MIL,@,MIA,L 95-137,240,32,84,.381,20,42,.476,12,42,.286,19,29,.655,95,51,96,.531,36,61,.590,15,35,.429,20,31,.645,137
33,2021-10-22,BOS,,TOR,L 83-115,240,32,82,.390,21,48,.438,11,34,.324,8,11,.727,83,42,100,.420,32,65,.492,10,35,.286,21,21,1.000,115
34,2021-10-22,TOR,@,BOS,W 115-83,240,42,100,.420,32,65,.492,10,35,.286,21,21,1.000,115,32,82,.390,21,48,.438,11,34,.324,8,11,.727,83
35,2021-10-22,CHI,,NOP,W 128-112,240,47,89,.528,33,61,.541,14,28,.500,20,25,.800,128,42,87,.483,27,58,.466,15,29,.517,13,16,.813,112
36,2021-10-22,NOP,@,CHI,L 112-128,240,42,87,.483,27,58,.466,15,29,.517,13,16,.813,112,47,89,.528,33,61,.541,14,28,.500,20,25,.800,128
37,2021-10-22,CHO,@,CLE,W 123-112,240,48,91,.527,35,59,.593,13,32,.406,14,17,.824,123,43,84,.512,34,53,.642,9,31,.290,17,20,.850,112
38,2021-10-22,CLE,,CHO,L 112-123,240,43,84,.512,34,53,.642,9,31,.290,17,20,.850,112,48,91,.527,35,59,.593,13,32,.406,14,17,.824,123
39,2021-10-22,DEN,,SAS,W 102-96,240,44,86,.512,35,56,.625,9,30,.300,5,8,.625,102,40,84,.476,34,60,.567,6,24,.250,10,14,.714,96
40,2021-10-22,SAS,@,DEN,L 96-102,240,40,84,.476,34,60,.567,6,24,.250,10,14,.714,96,44,86,.512,35,56,.625,9,30,.300,5,8,.625,102
41,2021-10-22,HOU,,OKC,W 124-91,240,48,95,.505,31,57,.544,17,38,.447,11,14,.786,124,34,91,.374,20,48,.417,14,43,.326,9,16,.563,91
42,2021-10-22,OKC,@,HOU,L 91-124,240,34,91,.374,20,48,.417,14,43,.326,9,16,.563,91,48,95,.505,31,57,.544,17,38,.447,11,14,.786,124
43,2021-10-22,LAL,,PHO,L 105-115,240,34,86,.395,19,52,.365,15,34,.441,22,29,.759,105,42,86,.488,32,54,.593,10,32,.313,21,28,.750,115
44,2021-10-22,PHO,@,LAL,W 115-105,240,42,86,.488,32,54,.593,10,32,.313,21,28,.750,115,34,86,.395,19,52,.365,15,34,.441,22,29,.759,105
45,2021-10-22,NYK,@,ORL,W 121-96,240,44,88,.500,20,34,.588,24,54,.444,9,17,.529,121,33,83,.398,16,40,.400,17,43,.395,13,15,.867,96
46,2021-10-22,ORL,,NYK,L 96-121,240,33,83,.398,16,40,.400,17,43,.395,13,15,.867,96,44,88,.500,20,34,.588,24,54,.444,9,17,.529,121
47,2021-10-22,BRK,@,PHI,W 114-109,240,41,88,.466,29,50,.580,12,38,.316,20,24,.833,114,43,91,.473,29,55,.527,14,36,.389,9,11,.818,109
48,2021-10-22,PHI,,BRK,L 109-114,240,43,91,.473,29,55,.527,14,36,.389,9,11,.818,109,41,88,.466,29,50,.580,12,38,.316,20,24,.833,114
49,2021-10-22,SAC,,UTA,L 101-110,240,39,99,.394,31,63,.492,8,36,.222,15,21,.714,101,37,90,.411,21,48,.438,16,42,.381,20,23,.870,110
50,2021-10-22,UTA,@,SAC,W 110-101,240,37,90,.411,21,48,.438,16,42,.381,20,23,.870,110,39,99,.394,31,63,.492,8,36,.222,15,21,.714,101
51,2021-10-22,IND,@,WAS,L 134-135 (OT),265,52,97,.536,37,63,.587,15,34,.441,15,20,.750,134,49,94,.521,30,56,.536,19,38,.500,18,19,.947,135
52,2021-10-22,WAS,,IND,W 135-134 (OT),265,49,94,.521,30,56,.536,19,38,.500,18,19,.947,135,52,97,.536,37,63,.587,15,34,.441,15,20,.750,134
53,2021-10-23,CHI,,DET,W 97-82,240,35,84,.417,24,58,.414,11,26,.423,16,19,.842,97,34,88,.386,29,60,.483,5,28,.179,9,15,.600,82
54,2021-10-23,DET,@,CHI,L 82-97,240,34,88,.386,29,60,.483,5,28,.179,9,15,.600,82,35,84,.417,24,58,.414,11,26,.423,16,19,.842,97
55,2021-10-23,ATL,@,CLE,L 95-101,240,38,99,.384,28,65,.431,10,34,.294,9,15,.600,95,37,89,.416,30,61,.492,7,28,.250,20,27,.741,101
56,2021-10-23,CLE,,ATL,W 101-95,240,37,89,.416,30,61,.492,7,28,.250,20,27,.741,101,38,99,.384,28,65,.431,10,34,.294,9,15,.600,95
57,2021-10-23,IND,,MIA,W 102-91 (OT),265,38,97,.392,28,58,.483,10,39,.256,16,21,.762,102,35,91,.385,26,58,.448,9,33,.273,12,14,.857,91
58,2021-10-23,MIA,@,IND,L 91-102 (OT),265,35,91,.385,26,58,.448,9,33,.273,12,14,.857,91,38,97,.392,28,58,.483,10,39,.256,16,21,.762,102
59,2021-10-23,LAC,,MEM,L 114-120,240,43,99,.434,30,60,.500,13,39,.333,15,17,.882,114,42,90,.467,27,54,.500,15,36,.417,21,25,.840,120
60,2021-10-23,MEM,@,LAC,W 120-114,240,42,90,.467,27,54,.500,15,36,.417,21,25,.840,120,43,99,.434,30,60,.500,13,39,.333,15,17,.882,114
61,2021-10-23,MIN,,NOP,W 96-89,240,39,96,.406,27,58,.466,12,38,.316,6,10,.600,96,31,89,.348,22,49,.449,9,40,.225,18,23,.783,89
62,2021-10-23,NOP,@,MIN,L 89-96,240,31,89,.348,22,49,.449,9,40,.225,18,23,.783,89,39,96,.406,27,58,.466,12,38,.316,6,10,.600,96
63,2021-10-23,PHO,@,POR,L 105-134,240,43,89,.483,34,61,.557,9,28,.321,10,15,.667,105,51,94,.543,30,44,.682,21,50,.420,11,17,.647,134
64,2021-10-23,POR,,PHO,W 134-105,240,51,94,.543,30,44,.682,21,50,.420,11,17,.647,134,43,89,.483,34,61,.557,9,28,.321,10,15,.667,105
65,2021-10-23,MIL,@,SAS,W 121-111,240,44,83,.530,29,48,.604,15,35,.429,18,22,.818,121,48,99,.485,38,60,.633,10,39,.256,5,6,.833,111
66,2021-10-23,SAS,,MIL,L 111-121,240,48,99,.485,38,60,.633,10,39,.256,5,6,.833,111,44,83,.530,29,48,.604,15,35,.429,18,22,.818,121
67,2021-10-23,DAL,@,TOR,W 103-95,240,38,91,.418,24,49,.490,14,42,.333,13,18,.722,103,34,85,.400,23,48,.479,11,37,.297,16,23,.696,95
68,2021-10-23,TOR,,DAL,L 95-103,240,34,85,.400,23,48,.479,11,37,.297,16,23,.696,95,38,91,.418,24,49,.490,14,42,.333,13,18,.722,103
69,2021-10-24,BRK,,CHO,L 95-111,240,38,87,.437,29,52,.558,9,35,.257,10,12,.833,95,43,94,.457,33,64,.516,10,30,.333,15,19,.789,111
70,2021-10-24,CHO,@,BRK,W 111-95,240,43,94,.457,33,64,.516,10,30,.333,15,19,.789,111,38,87,.437,29,52,.558,9,35,.257,10,12,.833,95
71,2021-10-24,BOS,@,HOU,W 107-97,240,38,86,.442,23,39,.590,15,47,.319,16,20,.800,107,32,75,.427,18,43,.419,14,32,.438,19,24,.792,97
72,2021-10-24,HOU,,BOS,L 97-107,240,32,75,.427,18,43,.419,14,32,.438,19,24,.792,97,38,86,.442,23,39,.590,15,47,.319,16,20,.800,107
73,2021-10-24,LAL,,MEM,W 121-118,240,45,84,.536,29,54,.537,16,30,.533,15,22,.682,121,45,100,.450,32,65,.492,13,35,.371,15,18,.833,118
74,2021-10-24,MEM,@,LAL,L 118-121,240,45,100,.450,32,65,.492,13,35,.371,15,18,.833,118,45,84,.536,29,54,.537,16,30,.533,15,22,.682,121
75,2021-10-24,NYK,,ORL,L 104-110,240,37,100,.370,24,52,.462,13,48,.271,17,25,.680,104,36,88,.409,24,45,.533,12,43,.279,26,34,.765,110
76,2021-10-24,ORL,@,NYK,W 110-104,240,36,88,.409,24,45,.533,12,43,.279,26,34,.765,110,37,100,.370,24,52,.462,13,48,.271,17,25,.680,104
77,2021-10-24,OKC,,PHI,L 103-115,240,40,84,.476,32,53,.604,8,31,.258,15,19,.789,103,41,88,.466,24,47,.511,17,41,.415,16,20,.800,115
78,2021-10-24,PHI,@,OKC,W 115-103,240,41,88,.466,24,47,.511,17,41,.415,16,20,.800,115,40,84,.476,32,53,.604,8,31,.258,15,19,.789,103
79,2021-10-24,GSW,@,SAC,W 119-107,240,43,97,.443,30,60,.500,13,37,.351,20,24,.833,119,42,86,.488,27,40,.675,15,46,.326,8,13,.615,107
80,2021-10-24,SAC,,GSW,L 107-119,240,42,86,.488,27,40,.675,15,46,.326,8,13,.615,107,43,97,.443,30,60,.500,13,37,.351,20,24,.833,119
81,2021-10-25,ATL,,DET,W 122-104,240,46,90,.511,34,58,.586,12,32,.375,18,21,.857,122,40,91,.440,31,58,.534,9,33,.273,15,18,.833,104
82,2021-10-25,DET,@,ATL,L 104-122,240,40,91,.440,31,58,.534,9,33,.273,15,18,.833,104,46,90,.511,34,58,.586,12,32,.375,18,21,.857,122
83,2021-10-25,BRK,,WAS,W 104-90,240,40,94,.426,30,59,.508,10,35,.286,14,17,.824,104,33,95,.347,24,56,.429,9,39,.231,15,20,.750,90
84,2021-10-25,WAS,@,BRK,L 90-104,240,33,95,.347,24,56,.429,9,39,.231,15,20,.750,90,40,94,.426,30,59,.508,10,35,.286,14,17,.824,104
85,2021-10-25,BOS,@,CHO,W 140-129 (OT),265,50,101,.495,31,51,.608,19,50,.380,21,25,.840,140,46,103,.447,27,59,.458,19,44,.432,18,28,.643,129
86,2021-10-25,CHO,,BOS,L 129-140 (OT),265,46,103,.447,27,59,.458,19,44,.432,18,28,.643,129,50,101,.495,31,51,.608,19,50,.380,21,25,.840,140
87,2021-10-25,CLE,@,DEN,W 99-87,240,38,82,.463,31,57,.544,7,25,.280,16,20,.800,99,35,86,.407,26,48,.542,9,38,.237,8,12,.667,87
88,2021-10-25,DEN,,CLE,L 87-99,240,35,86,.407,26,48,.542,9,38,.237,8,12,.667,87,38,82,.463,31,57,.544,7,25,.280,16,20,.800,99
89,2021-10-25,IND,,MIL,L 109-119,240,40,90,.444,26,54,.481,14,36,.389,15,17,.882,109,41,85,.482,30,53,.566,11,32,.344,26,31,.839,119
90,2021-10-25,MIL,@,IND,W 119-109,240,41,85,.482,30,53,.566,11,32,.344,26,31,.839,119,40,90,.444,26,54,.481,14,36,.389,15,17,.882,109
91,2021-10-25,LAC,,POR,W 116-86,240,44,93,.473,30,50,.600,14,43,.326,14,19,.737,116,32,85,.376,24,48,.500,8,37,.216,14,18,.778,86
92,2021-10-25,POR,@,LAC,L 86-116,240,32,85,.376,24,48,.500,8,37,.216,14,18,.778,86,44,93,.473,30,50,.600,14,43,.326,14,19,.737,116
93,2021-10-25,MIA,,ORL,W 107-90,240,41,87,.471,35,60,.583,6,27,.222,19,19,1.000,107,33,81,.407,21,37,.568,12,44,.273,12,19,.632,90
94,2021-10-25,ORL,@,MIA,L 90-107,240,33,81,.407,21,37,.568,12,44,.273,12,19,.632,90,41,87,.471,35,60,.583,6,27,.222,19,19,1.000,107
95,2021-10-25,MIN,,NOP,L 98-107,240,31,90,.344,16,40,.400,15,50,.300,21,27,.778,98,39,87,.448,29,57,.509,10,30,.333,19,23,.826,107
96,2021-10-25,NOP,@,MIN,W 107-98,240,39,87,.448,29,57,.509,10,30,.333,19,23,.826,107,31,90,.344,16,40,.400,15,50,.300,21,27,.778,98
97,2021-10-25,CHI,@,TOR,W 111-108,240,39,81,.481,27,54,.500,12,27,.444,21,22,.955,111,40,83,.482,28,53,.528,12,30,.400,16,20,.800,108
98,2021-10-25,TOR,,CHI,L 108-111,240,40,83,.482,28,53,.528,12,30,.400,16,20,.800,108,39,81,.481,27,54,.500,12,27,.444,21,22,.955,111
99,2021-10-26,DAL,,HOU,W 116-106,240,43,93,.462,31,50,.620,12,43,.279,18,25,.720,116,36,86,.419,20,47,.426,16,39,.410,18,26,.692,106
100,2021-10-26,HOU,@,DAL,L 106-116,240,36,86,.419,20,47,.426,16,39,.410,18,26,.692,106,43,93,.462,31,50,.620,12,43,.279,18,25,.720,116
101,2021-10-26,NYK,,PHI,W 112-99,240,41,87,.471,25,50,.500,16,37,.432,14,15,.933,112,36,82,.439,24,41,.585,12,41,.293,15,17,.882,99
102,2021-10-26,PHI,@,NYK,L 99-112,240,36,82,.439,24,41,.585,12,41,.293,15,17,.882,99,41,87,.471,25,50,.500,16,37,.432,14,15,.933,112
103,2021-10-26,GSW,@,OKC,W 106-98,240,39,83,.470,25,43,.581,14,40,.350,14,18,.778,106,36,86,.419,24,52,.462,12,34,.353,14,17,.824,98
104,2021-10-26,OKC,,GSW,L 98-106,240,36,86,.419,24,52,.462,12,34,.353,14,17,.824,98,39,83,.470,25,43,.581,14,40,.350,14,18,.778,106
105,2021-10-26,LAL,@,SAS,W 125-121 (OT),265,50,105,.476,42,75,.560,8,30,.267,17,22,.773,125,48,108,.444,35,72,.486,13,36,.361,12,22,.545,121
106,2021-10-26,SAS,,LAL,L 121-125 (OT),265,48,108,.444,35,72,.486,13,36,.361,12,22,.545,121,50,105,.476,42,75,.560,8,30,.267,17,22,.773,125
107,2021-10-26,DEN,@,UTA,L 110-122,240,42,83,.506,32,55,.582,10,28,.357,16,24,.667,110,44,85,.518,32,46,.696,12,39,.308,22,29,.759,122
108,2021-10-26,UTA,,DEN,W 122-110,240,44,85,.518,32,46,.696,12,39,.308,22,29,.759,122,42,83,.506,32,55,.582,10,28,.357,16,24,.667,110
109,2021-10-27,BOS,,WAS,L 107-116,240,37,85,.435,27,56,.482,10,29,.345,23,28,.821,107,43,84,.512,34,59,.576,9,25,.360,21,29,.724,116
110,2021-10-27,WAS,@,BOS,W 116-107,240,43,84,.512,34,59,.576,9,25,.360,21,29,.724,116,37,85,.435,27,56,.482,10,29,.345,23,28,.821,107
111,2021-10-27,BRK,,MIA,L 93-106,240,33,85,.388,19,42,.452,14,43,.326,13,14,.929,93,38,96,.396,30,67,.448,8,29,.276,22,26,.846,106
112,2021-10-27,MIA,@,BRK,W 106-93,240,38,96,.396,30,67,.448,8,29,.276,22,26,.846,106,33,85,.388,19,42,.452,14,43,.326,13,14,.929,93
113,2021-10-27,CLE,@,LAC,W 92-79,240,33,81,.407,30,61,.492,3,20,.150,23,27,.852,92,31,87,.356,22,46,.478,9,41,.220,8,13,.615,79
114,2021-10-27,LAC,,CLE,L 79-92,240,31,87,.356,22,46,.478,9,41,.220,8,13,.615,79,33,81,.407,30,61,.492,3,20,.150,23,27,.852,92
115,2021-10-27,MIL,,MIN,L 108-113,240,39,95,.411,25,44,.568,14,51,.275,16,21,.762,108,43,91,.473,30,46,.652,13,45,.289,14,17,.824,113
116,2021-10-27,MIN,@,MIL,W 113-108,240,43,91,.473,30,46,.652,13,45,.289,14,17,.824,113,39,95,.411,25,44,.568,14,51,.275,16,21,.762,108
117,2021-10-27,ATL,@,NOP,W 102-99,240,40,96,.417,32,66,.485,8,30,.267,14,17,.824,102,40,93,.430,29,57,.509,11,36,.306,8,9,.889,99
118,2021-10-27,NOP,,ATL,L 99-102,240,40,93,.430,29,57,.509,11,36,.306,8,9,.889,99,40,96,.417,32,66,.485,8,30,.267,14,17,.824,102
119,2021-10-27,LAL,@,OKC,L 115-123,240,46,92,.500,35,57,.614,11,35,.314,12,14,.857,115,43,86,.500,28,49,.571,15,37,.405,22,29,.759,123
120,2021-10-27,OKC,,LAL,W 123-115,240,43,86,.500,28,49,.571,15,37,.405,22,29,.759,123,46,92,.500,35,57,.614,11,35,.314,12,14,.857,115
121,2021-10-27,CHO,@,ORL,W 120-111,240,43,83,.518,29,53,.547,14,30,.467,20,24,.833,120,43,88,.489,28,48,.583,15,40,.375,10,13,.769,111
122,2021-10-27,ORL,,CHO,L 111-120,240,43,88,.489,28,48,.583,15,40,.375,10,13,.769,111,43,83,.518,29,53,.547,14,30,.467,20,24,.833,120
123,2021-10-27,PHO,,SAC,L 107-110,240,42,93,.452,36,71,.507,6,22,.273,17,24,.708,107,42,95,.442,27,57,.474,15,38,.395,11,15,.733,110
124,2021-10-27,SAC,@,PHO,W 110-107,240,42,95,.442,27,57,.474,15,38,.395,11,15,.733,110,42,93,.452,36,71,.507,6,22,.273,17,24,.708,107
125,2021-10-27,MEM,@,POR,L 96-116,240,35,96,.365,18,46,.391,17,50,.340,9,19,.474,96,39,84,.464,24,48,.500,15,36,.417,23,31,.742,116
126,2021-10-27,POR,,MEM,W 116-96,240,39,84,.464,24,48,.500,15,36,.417,23,31,.742,116,35,96,.365,18,46,.391,17,50,.340,9,19,.474,96
127,2021-10-27,IND,@,TOR,L 100-118,240,38,79,.481,28,50,.560,10,29,.345,14,17,.824,100,46,100,.460,32,70,.457,14,30,.467,12,19,.632,118
128,2021-10-27,TOR,,IND,W 118-100,240,46,100,.460,32,70,.457,14,30,.467,12,19,.632,118,38,79,.481,28,50,.560,10,29,.345,14,17,.824,100
129,2021-10-28,CHI,,NYK,L 103-104,240,36,84,.429,25,52,.481,11,32,.344,20,22,.909,103,39,85,.459,28,56,.500,11,29,.379,15,20,.750,104
130,2021-10-28,NYK,@,CHI,W 104-103,240,39,85,.459,28,56,.500,11,29,.379,15,20,.750,104,36,84,.429,25,52,.481,11,32,.344,20,22,.909,103
131,2021-10-28,DAL,,SAS,W 104-99,240,41,89,.461,23,44,.523,18,45,.400,4,13,.308,104,39,88,.443,27,58,.466,12,30,.400,9,15,.600,99
132,2021-10-28,SAS,@,DAL,L 99-104,240,39,88,.443,27,58,.466,12,30,.400,9,15,.600,99,41,89,.461,23,44,.523,18,45,.400,4,13,.308,104
133,2021-10-28,GSW,,MEM,L 101-104 (OT),265,39,90,.433,25,50,.500,14,40,.350,9,12,.750,101,39,97,.402,27,49,.551,12,48,.250,14,14,1.000,104
134,2021-10-28,MEM,@,GSW,W 104-101 (OT),265,39,97,.402,27,49,.551,12,48,.250,14,14,1.000,104,39,90,.433,25,50,.500,14,40,.350,9,12,.750,101
135,2021-10-28,HOU,,UTA,L 91-122,240,31,95,.326,22,51,.431,9,44,.205,20,23,.870,91,41,85,.482,25,39,.641,16,46,.348,24,30,.800,122
136,2021-10-28,UTA,@,HOU,W 122-91,240,41,85,.482,25,39,.641,16,46,.348,24,30,.800,122,31,95,.326,22,51,.431,9,44,.205,20,23,.870,91
137,2021-10-28,DET,@,PHI,L 102-110,240,35,86,.407,22,47,.468,13,39,.333,19,27,.704,102,38,76,.500,26,49,.531,12,27,.444,22,24,.917,110
138,2021-10-28,PHI,,DET,W 110-102,240,38,76,.500,26,49,.531,12,27,.444,22,24,.917,110,35,86,.407,22,47,.468,13,39,.333,19,27,.704,102
139,2021-10-28,ATL,@,WAS,L 111-122,240,48,88,.545,42,67,.627,6,21,.286,9,14,.643,111,46,99,.465,33,65,.508,13,34,.382,17,21,.810,122
140,2021-10-28,WAS,,ATL,W 122-111,240,46,99,.465,33,65,.508,13,34,.382,17,21,.810,122,48,88,.545,42,67,.627,6,21,.286,9,14,.643,111
141,2021-10-29,BRK,,IND,W 105-98,240,34,76,.447,28,50,.560,6,26,.231,31,41,.756,105,37,93,.398,29,64,.453,8,29,.276,16,23,.696,98
142,2021-10-29,IND,@,BRK,L 98-105,240,37,93,.398,29,64,.453,8,29,.276,16,23,.696,98,34,76,.447,28,50,.560,6,26,.231,31,41,.756,105
143,2021-10-29,DAL,@,DEN,L 75-106,240,23,78,.295,15,41,.366,8,37,.216,21,27,.778,75,43,83,.518,32,47,.681,11,36,.306,9,13,.692,106
144,2021-10-29,DEN,,DAL,W 106-75,240,43,83,.518,32,47,.681,11,36,.306,9,13,.692,106,23,78,.295,15,41,.366,8,37,.216,21,27,.778,75
145,2021-10-29,CLE,@,LAL,L 101-113,240,37,87,.425,25,53,.472,12,34,.353,15,22,.682,101,46,84,.548,34,57,.596,12,27,.444,9,10,.900,113
146,2021-10-29,LAL,,CLE,W 113-101,240,46,84,.548,34,57,.596,12,27,.444,9,10,.900,113,37,87,.425,25,53,.472,12,34,.353,15,22,.682,101
147,2021-10-29,CHO,@,MIA,L 99-114,240,35,90,.389,22,53,.415,13,37,.351,16,22,.727,99,43,91,.473,34,56,.607,9,35,.257,19,19,1.000,114
148,2021-10-29,MIA,,CHO,W 114-99,240,43,91,.473,34,56,.607,9,35,.257,19,19,1.000,114,35,90,.389,22,53,.415,13,37,.351,16,22,.727,99
149,2021-10-29,NOP,,SAC,L 109-113,240,42,98,.429,33,64,.516,9,34,.265,16,25,.640,109,40,80,.500,31,53,.585,9,27,.333,24,25,.960,113
150,2021-10-29,SAC,@,NOP,W 113-109,240,40,80,.500,31,53,.585,9,27,.333,24,25,.960,113,42,98,.429,33,64,.516,9,34,.265,16,25,.640,109
151,2021-10-29,LAC,@,POR,L 92-111,240,34,87,.391,19,45,.422,15,42,.357,9,16,.563,92,41,98,.418,22,57,.386,19,41,.463,10,16,.625,111
152,2021-10-29,POR,,LAC,W 111-92,240,41,98,.418,22,57,.386,19,41,.463,10,16,.625,111,34,87,.391,19,45,.422,15,42,.357,9,16,.563,92
153,2021-10-29,ORL,@,TOR,L 109-110,240,41,87,.471,25,53,.472,16,34,.471,11,16,.688,109,43,86,.500,34,56,.607,9,30,.300,15,22,.682,110
154,2021-10-29,TOR,,ORL,W 110-109,240,43,86,.500,34,56,.607,9,30,.300,15,22,.682,110,41,87,.471,25,53,.472,16,34,.471,11,16,.688,109
155,2021-10-30,CHI,,UTA,W 107-99,240,39,91,.429,34,70,.486,5,21,.238,24,30,.800,107,35,92,.380,24,54,.444,11,38,.289,18,19,.947,99
156,2021-10-30,UTA,@,CHI,L 99-107,240,35,92,.380,24,54,.444,11,38,.289,18,19,.947,99,39,91,.429,34,70,.486,5,21,.238,24,30,.800,107
157,2021-10-30,DET,,ORL,W 110-103,240,36,89,.404,22,46,.478,14,43,.326,24,30,.800,110,38,87,.437,22,55,.400,16,32,.500,11,15,.733,103
158,2021-10-30,ORL,@,DET,L 103-110,240,38,87,.437,22,55,.400,16,32,.500,11,15,.733,103,36,89,.404,22,46,.478,14,43,.326,24,30,.800,110
159,2021-10-30,GSW,,OKC,W 103-82,240,39,92,.424,18,38,.474,21,54,.389,4,8,.500,103,29,83,.349,21,44,.477,8,39,.205,16,21,.762,82
160,2021-10-30,OKC,@,GSW,L 82-103,240,29,83,.349,21,44,.477,8,39,.205,16,21,.762,82,39,92,.424,18,38,.474,21,54,.389,4,8,.500,103
161,2021-10-30,IND,,TOR,L 94-97,240,35,81,.432,22,38,.579,13,43,.302,11,16,.688,94,39,92,.424,28,60,.467,11,32,.344,8,12,.667,97
162,2021-10-30,TOR,@,IND,W 97-94,240,39,92,.424,28,60,.467,11,32,.344,8,12,.667,97,35,81,.432,22,38,.579,13,43,.302,11,16,.688,94
163,2021-10-30,MEM,,MIA,L 103-129,240,34,88,.386,18,38,.474,16,50,.320,19,21,.905,103,46,88,.523,25,51,.490,21,37,.568,16,19,.842,129
164,2021-10-30,MIA,@,MEM,W 129-103,240,46,88,.523,25,51,.490,21,37,.568,16,19,.842,129,34,88,.386,18,38,.474,16,50,.320,19,21,.905,103
165,2021-10-30,MIL,,SAS,L 93-102,240,36,89,.404,26,50,.520,10,39,.256,11,16,.688,93,39,95,.411,32,64,.500,7,31,.226,17,24,.708,102
166,2021-10-30,SAS,@,MIL,W 102-93,240,39,95,.411,32,64,.500,7,31,.226,17,24,.708,102,36,89,.404,26,50,.520,10,39,.256,11,16,.688,93
167,2021-10-30,DEN,@,MIN,W 93-91,240,36,88,.409,27,51,.529,9,37,.243,12,16,.750,93,35,89,.393,22,48,.458,13,41,.317,8,9,.889,91
168,2021-10-30,MIN,,DEN,L 91-93,240,35,89,.393,22,48,.458,13,41,.317,8,9,.889,91,36,88,.409,27,51,.529,9,37,.243,12,16,.750,93
169,2021-10-30,NOP,,NYK,L 117-123,240,42,92,.457,31,59,.525,11,33,.333,22,24,.917,117,42,81,.519,23,48,.479,19,33,.576,20,25,.800,123
170,2021-10-30,NYK,@,NOP,W 123-117,240,42,81,.519,23,48,.479,19,33,.576,20,25,.800,123,42,92,.457,31,59,.525,11,33,.333,22,24,.917,117
171,2021-10-30,ATL,@,PHI,L 94-122,240,36,95,.379,28,73,.384,8,22,.364,14,19,.737,94,46,86,.535,34,48,.708,12,38,.316,18,19,.947,122
172,2021-10-30,PHI,,ATL,W 122-94,240,46,86,.535,34,48,.708,12,38,.316,18,19,.947,122,36,95,.379,28,73,.384,8,22,.364,14,19,.737,94
173,2021-10-30,CLE,@,PHO,L 92-101,240,36,91,.396,22,47,.468,14,44,.318,6,7,.857,92,39,84,.464,33,58,.569,6,26,.231,17,27,.630,101
174,2021-10-30,PHO,,CLE,W 101-92,240,39,84,.464,33,58,.569,6,26,.231,17,27,.630,101,36,91,.396,22,47,.468,14,44,.318,6,7,.857,92
175,2021-10-30,BOS,@,WAS,L 112-115 (2OT),290,44,107,.411,42,81,.519,2,26,.077,22,25,.880,112,38,104,.365,28,68,.412,10,36,.278,29,36,.806,115
176,2021-10-30,WAS,,BOS,W 115-112 (2OT),290,38,104,.365,28,68,.412,10,36,.278,29,36,.806,115,44,107,.411,42,81,.519,2,26,.077,22,25,.880,112
177,2021-10-31,BRK,,DET,W 117-91,240,47,72,.653,34,47,.723,13,25,.520,10,16,.625,117,32,79,.405,20,46,.435,12,33,.364,15,22,.682,91
178,2021-10-31,DET,@,BRK,L 91-117,240,32,79,.405,20,46,.435,12,33,.364,15,22,.682,91,47,72,.653,34,47,.723,13,25,.520,10,16,.625,117
179,2021-10-31,CHO,,POR,W 125-113,240,46,89,.517,26,47,.553,20,42,.476,13,21,.619,125,43,97,.443,26,43,.605,17,54,.315,10,11,.909,113
180,2021-10-31,POR,@,CHO,L 113-125,240,43,97,.443,26,43,.605,17,54,.315,10,11,.909,113,46,89,.517,26,47,.553,20,42,.476,13,21,.619,125
181,2021-10-31,DAL,,SAC,W 105-99,240,40,90,.444,28,53,.528,12,37,.324,13,20,.650,105,38,96,.396,31,60,.517,7,36,.194,16,20,.800,99
182,2021-10-31,SAC,@,DAL,L 99-105,240,38,96,.396,31,60,.517,7,36,.194,16,20,.800,99,40,90,.444,28,53,.528,12,37,.324,13,20,.650,105
183,2021-10-31,HOU,@,LAL,L 85-95,240,32,76,.421,26,48,.542,6,28,.214,15,29,.517,85,39,96,.406,30,65,.462,9,31,.290,8,13,.615,95
184,2021-10-31,LAL,,HOU,W 95-85,240,39,96,.406,30,65,.462,9,31,.290,8,13,.615,95,32,76,.421,26,48,.542,6,28,.214,15,29,.517,85
185,2021-10-31,MIL,,UTA,L 95-107,240,39,96,.406,27,55,.491,12,41,.293,5,6,.833,95,35,75,.467,23,38,.605,12,37,.324,25,27,.926,107
186,2021-10-31,UTA,@,MIL,W 107-95,240,35,75,.467,23,38,.605,12,37,.324,25,27,.926,107,39,96,.406,27,55,.491,12,41,.293,5,6,.833,95
187,2021-11-01,ATL,,WAS,W 118-111,240,38,83,.458,25,49,.510,13,34,.382,29,29,1.000,118,41,86,.477,28,47,.596,13,39,.333,16,16,1.000,111
188,2021-11-01,WAS,@,ATL,L 111-118,240,41,86,.477,28,47,.596,13,39,.333,16,16,1.000,111,38,83,.458,25,49,.510,13,34,.382,29,29,1.000,118
189,2021-11-01,BOS,,CHI,L 114-128,240,42,96,.438,27,63,.429,15,33,.455,15,20,.750,114,49,86,.570,36,55,.655,13,31,.419,17,18,.944,128
190,2021-11-01,CHI,@,BOS,W 128-114,240,49,86,.570,36,55,.655,13,31,.419,17,18,.944,128,42,96,.438,27,63,.429,15,33,.455,15,20,.750,114
191,2021-11-01,CHO,,CLE,L 110-113,240,42,101,.416,27,62,.435,15,39,.385,11,15,.733,110,39,90,.433,30,62,.484,9,28,.321,26,38,.684,113
192,2021-11-01,CLE,@,CHO,W 113-110,240,39,90,.433,30,62,.484,9,28,.321,26,38,.684,113,42,101,.416,27,62,.435,15,39,.385,11,15,.733,110
193,2021-11-01,IND,,SAS,W 131-118,240,52,91,.571,34,53,.642,18,38,.474,9,12,.750,131,47,89,.528,33,61,.541,14,28,.500,10,14,.714,118
194,2021-11-01,SAS,@,IND,L 118-131,240,47,89,.528,33,61,.541,14,28,.500,10,14,.714,118,52,91,.571,34,53,.642,18,38,.474,9,12,.750,131
195,2021-11-01,LAC,,OKC,W 99-94,240,35,92,.380,20,50,.400,15,42,.357,14,19,.737,99,35,90,.389,24,53,.453,11,37,.297,13,16,.813,94
196,2021-11-01,OKC,@,LAC,L 94-99,240,35,90,.389,24,53,.453,11,37,.297,13,16,.813,94,35,92,.380,20,50,.400,15,42,.357,14,19,.737,99
197,2021-11-01,DEN,@,MEM,L 97-106,240,39,88,.443,30,50,.600,9,38,.237,10,15,.667,97,44,97,.454,31,63,.492,13,34,.382,5,7,.714,106
198,2021-11-01,MEM,,DEN,W 106-97,240,44,97,.454,31,63,.492,13,34,.382,5,7,.714,106,39,88,.443,30,50,.600,9,38,.237,10,15,.667,97
199,2021-11-01,MIN,,ORL,L 97-115,240,36,97,.371,22,46,.478,14,51,.275,11,19,.579,97,37,82,.451,20,39,.513,17,43,.395,24,30,.800,115
200,2021-11-01,ORL,@,MIN,W 115-97,240,37,82,.451,20,39,.513,17,43,.395,24,30,.800,115,36,97,.371,22,46,.478,14,51,.275,11,19,.579,97
201,2021-11-01,NYK,,TOR,L 104-113,240,35,76,.461,19,38,.500,16,38,.421,18,24,.750,104,43,99,.434,29,57,.509,14,42,.333,13,14,.929,113
202,2021-11-01,TOR,@,NYK,W 113-104,240,43,99,.434,29,57,.509,14,42,.333,13,14,.929,113,35,76,.461,19,38,.500,16,38,.421,18,24,.750,104
203,2021-11-01,PHI,,POR,W 113-103,240,43,83,.518,30,47,.638,13,36,.361,14,16,.875,113,40,84,.476,28,50,.560,12,34,.353,11,18,.611,103
204,2021-11-01,POR,@,PHI,L 103-113,240,40,84,.476,28,50,.560,12,34,.353,11,18,.611,103,43,83,.518,30,47,.638,13,36,.361,14,16,.875,113
205,2021-11-02,DAL,,MIA,L 110-125,240,37,84,.440,23,42,.548,14,42,.333,22,31,.710,110,43,83,.518,30,58,.517,13,25,.520,26,30,.867,125
206,2021-11-02,MIA,@,DAL,W 125-110,240,43,83,.518,30,58,.517,13,25,.520,26,30,.867,125,37,84,.440,23,42,.548,14,42,.333,22,31,.710,110
207,2021-11-02,DET,,MIL,L 89-117,240,30,93,.323,22,46,.478,8,47,.170,21,30,.700,89,42,84,.500,25,47,.532,17,37,.459,16,21,.762,117
208,2021-11-02,MIL,@,DET,W 117-89,240,42,84,.500,25,47,.532,17,37,.459,16,21,.762,117,30,93,.323,22,46,.478,8,47,.170,21,30,.700,89
209,2021-11-02,HOU,@,LAL,L 117-119,240,48,91,.527,32,49,.653,16,42,.381,5,12,.417,117,49,93,.527,43,68,.632,6,25,.240,15,20,.750,119
210,2021-11-02,LAL,,HOU,W 119-117,240,49,93,.527,43,68,.632,6,25,.240,15,20,.750,119,48,91,.527,32,49,.653,16,42,.381,5,12,.417,117
211,2021-11-02,NOP,@,PHO,L 100-112,240,36,91,.396,23,52,.442,13,39,.333,15,16,.938,100,43,82,.524,34,56,.607,9,26,.346,17,18,.944,112
212,2021-11-02,PHO,,NOP,W 112-100,240,43,82,.524,34,56,.607,9,26,.346,17,18,.944,112,36,91,.396,23,52,.442,13,39,.333,15,16,.938,100
213,2021-11-02,SAC,@,UTA,L 113-119,240,42,93,.452,30,62,.484,12,31,.387,17,24,.708,113,43,98,.439,29,50,.580,14,48,.292,19,27,.704,119
214,2021-11-02,UTA,,SAC,W 119-113,240,43,98,.439,29,50,.580,14,48,.292,19,27,.704,119,42,93,.452,30,62,.484,12,31,.387,17,24,.708,113
215,2021-11-03,ATL,@,BRK,L 108-117,240,41,94,.436,28,59,.475,13,35,.371,13,15,.867,108,43,88,.489,21,40,.525,22,48,.458,9,12,.750,117
216,2021-11-03,BRK,,ATL,W 117-108,240,43,88,.489,21,40,.525,22,48,.458,9,12,.750,117,41,94,.436,28,59,.475,13,35,.371,13,15,.867,108
217,2021-11-03,CLE,,POR,W 107-104,240,39,74,.527,24,44,.545,15,30,.500,14,18,.778,107,40,90,.444,27,53,.509,13,37,.351,11,17,.647,104
218,2021-11-03,POR,@,CLE,L 104-107,240,40,90,.444,27,53,.509,13,37,.351,11,17,.647,104,39,74,.527,24,44,.545,15,30,.500,14,18,.778,107
219,2021-11-03,CHO,@,GSW,L 92-114,240,34,91,.374,24,55,.436,10,36,.278,14,19,.737,92,42,86,.488,24,41,.585,18,45,.400,12,18,.667,114
220,2021-11-03,GSW,,CHO,W 114-92,240,42,86,.488,24,41,.585,18,45,.400,12,18,.667,114,34,91,.374,24,55,.436,10,36,.278,14,19,.737,92
221,2021-11-03,IND,,NYK,W 111-98,240,42,91,.462,26,50,.520,16,41,.390,11,14,.786,111,36,87,.414,31,63,.492,5,24,.208,21,27,.778,98
222,2021-11-03,NYK,@,IND,L 98-111,240,36,87,.414,31,63,.492,5,24,.208,21,27,.778,98,42,91,.462,26,50,.520,16,41,.390,11,14,.786,111
223,2021-11-03,DEN,@,MEM,L 106-108,240,43,91,.473,35,64,.547,8,27,.296,12,13,.923,106,42,81,.519,26,47,.553,16,34,.471,8,14,.571,108
224,2021-11-03,MEM,,DEN,W 108-106,240,42,81,.519,26,47,.553,16,34,.471,8,14,.571,108,43,91,.473,35,64,.547,8,27,.296,12,13,.923,106
225,2021-11-03,LAC,@,MIN,W 126-115,240,47,78,.603,26,42,.619,21,36,.583,11,12,.917,126,43,94,.457,29,54,.537,14,40,.350,15,16,.938,115
226,2021-11-03,MIN,,LAC,L 115-126,240,43,94,.457,29,54,.537,14,40,.350,15,16,.938,115,47,78,.603,26,42,.619,21,36,.583,11,12,.917,126
227,2021-11-03,BOS,@,ORL,W 92-79,240,33,79,.418,23,42,.548,10,37,.270,16,25,.640,92,27,84,.321,18,41,.439,9,43,.209,16,20,.800,79
228,2021-11-03,ORL,,BOS,L 79-92,240,27,84,.321,18,41,.439,9,43,.209,16,20,.800,79,33,79,.418,23,42,.548,10,37,.270,16,25,.640,92
229,2021-11-03,CHI,@,PHI,L 98-103,240,38,82,.463,32,61,.525,6,21,.286,16,18,.889,98,38,77,.494,26,49,.531,12,28,.429,15,21,.714,103
230,2021-11-03,PHI,,CHI,W 103-98,240,38,77,.494,26,49,.531,12,28,.429,15,21,.714,103,38,82,.463,32,61,.525,6,21,.286,16,18,.889,98
231,2021-11-03,NOP,@,SAC,L 99-112,240,37,86,.430,25,52,.481,12,34,.353,13,15,.867,99,42,80,.525,32,50,.640,10,30,.333,18,22,.818,112
232,2021-11-03,SAC,,NOP,W 112-99,240,42,80,.525,32,50,.640,10,30,.333,18,22,.818,112,37,86,.430,25,52,.481,12,34,.353,13,15,.867,99
233,2021-11-03,DAL,@,SAS,W 109-108,240,40,93,.430,32,59,.542,8,34,.235,21,29,.724,109,43,88,.489,36,67,.537,7,21,.333,15,20,.750,108
234,2021-11-03,SAS,,DAL,L 108-109,240,43,88,.489,36,67,.537,7,21,.333,15,20,.750,108,40,93,.430,32,59,.542,8,34,.235,21,29,.724,109
235,2021-11-03,TOR,@,WAS,W 109-100,240,41,88,.466,31,63,.492,10,25,.400,17,20,.850,109,34,78,.436,26,46,.565,8,32,.250,24,30,.800,100
236,2021-11-03,WAS,,TOR,L 100-109,240,34,78,.436,26,46,.565,8,32,.250,24,30,.800,100,41,88,.466,31,63,.492,10,25,.400,17,20,.850,109
237,2021-11-04,ATL,,UTA,L 98-116,240,35,82,.427,28,54,.519,7,28,.250,21,26,.808,98,41,81,.506,24,40,.600,17,41,.415,17,23,.739,116
238,2021-11-04,UTA,@,ATL,W 116-98,240,41,81,.506,24,40,.600,17,41,.415,17,23,.739,116,35,82,.427,28,54,.519,7,28,.250,21,26,.808,98
239,2021-11-04,DET,,PHI,L 98-109,240,35,87,.402,24,51,.471,11,36,.306,17,19,.895,98,41,83,.494,29,51,.569,12,32,.375,15,22,.682,109
240,2021-11-04,PHI,@,DET,W 109-98,240,41,83,.494,29,51,.569,12,32,.375,15,22,.682,109,35,87,.402,24,51,.471,11,36,.306,17,19,.895,98
241,2021-11-04,LAL,,OKC,L 104-107,240,39,94,.415,27,61,.443,12,33,.364,14,17,.824,104,37,87,.425,22,46,.478,15,41,.366,18,26,.692,107
242,2021-11-04,OKC,@,LAL,W 107-104,240,37,87,.425,22,46,.478,15,41,.366,18,26,.692,107,39,94,.415,27,61,.443,12,33,.364,14,17,.824,104
243,2021-11-04,BOS,@,MIA,W 95-78,240,31,78,.397,15,37,.405,16,41,.390,17,20,.850,95,28,81,.346,19,40,.475,9,41,.220,13,19,.684,78
244,2021-11-04,MIA,,BOS,L 78-95,240,28,81,.346,19,40,.475,9,41,.220,13,19,.684,78,31,78,.397,15,37,.405,16,41,.390,17,20,.850,95
245,2021-11-04,HOU,@,PHO,L 111-123,240,38,88,.432,27,56,.482,11,32,.344,24,28,.857,111,44,93,.473,30,62,.484,14,31,.452,21,23,.913,123
246,2021-11-04,PHO,,HOU,W 123-111,240,44,93,.473,30,62,.484,14,31,.452,21,23,.913,123,38,88,.432,27,56,.482,11,32,.344,24,28,.857,111
247,2021-11-05,BRK,@,DET,W 96-90,240,36,80,.450,25,53,.472,11,27,.407,13,14,.929,96,33,87,.379,22,53,.415,11,34,.324,13,18,.722,90
248,2021-11-05,DET,,BRK,L 90-96,240,33,87,.379,22,53,.415,11,34,.324,13,18,.722,90,36,80,.450,25,53,.472,11,27,.407,13,14,.929,96
249,2021-11-05,GSW,,NOP,W 126-85,240,47,91,.516,27,41,.659,20,50,.400,12,14,.857,126,31,88,.352,20,44,.455,11,44,.250,12,16,.750,85
250,2021-11-05,NOP,@,GSW,L 85-126,240,31,88,.352,20,44,.455,11,44,.250,12,16,.750,85,47,91,.516,27,41,.659,20,50,.400,12,14,.857,126
251,2021-11-05,MIL,,NYK,L 98-113,240,33,82,.402,17,39,.436,16,43,.372,16,21,.762,98,41,96,.427,31,56,.554,10,40,.250,21,26,.808,113
252,2021-11-05,NYK,@,MIL,W 113-98,240,41,96,.427,31,56,.554,10,40,.250,21,26,.808,113,33,82,.402,17,39,.436,16,43,.372,16,21,.762,98
253,2021-11-05,LAC,@,MIN,W 104-84,240,36,88,.409,30,60,.500,6,28,.214,26,32,.813,104,31,89,.348,14,37,.378,17,52,.327,5,7,.714,84
254,2021-11-05,MIN,,LAC,L 84-104,240,31,89,.348,14,37,.378,17,52,.327,5,7,.714,84,36,88,.409,30,60,.500,6,28,.214,26,32,.813,104
255,2021-11-05,ORL,,SAS,L 89-102,240,35,89,.393,23,48,.479,12,41,.293,7,10,.700,89,40,90,.444,34,71,.479,6,19,.316,16,18,.889,102
256,2021-11-05,SAS,@,ORL,W 102-89,240,40,90,.444,34,71,.479,6,19,.316,16,18,.889,102,35,89,.393,23,48,.479,12,41,.293,7,10,.700,89
257,2021-11-05,IND,@,POR,L 106-110,240,43,88,.489,29,46,.630,14,42,.333,6,10,.600,106,40,82,.488,23,43,.535,17,39,.436,13,15,.867,110
258,2021-11-05,POR,,IND,W 110-106,240,40,82,.488,23,43,.535,17,39,.436,13,15,.867,110,43,88,.489,29,46,.630,14,42,.333,6,10,.600,106
259,2021-11-05,CHO,@,SAC,L 110-140,240,43,92,.467,32,57,.561,11,35,.314,13,21,.619,110,48,87,.552,26,43,.605,22,44,.500,22,26,.846,140
260,2021-11-05,SAC,,CHO,W 140-110,240,48,87,.552,26,43,.605,22,44,.500,22,26,.846,140,43,92,.467,32,57,.561,11,35,.314,13,21,.619,110
261,2021-11-05,CLE,@,TOR,W 102-101,240,38,83,.458,28,53,.528,10,30,.333,16,19,.842,102,42,99,.424,30,72,.417,12,27,.444,5,9,.556,101
262,2021-11-05,TOR,,CLE,L 101-102,240,42,99,.424,30,72,.417,12,27,.444,5,9,.556,101,38,83,.458,28,53,.528,10,30,.333,16,19,.842,102
263,2021-11-05,MEM,@,WAS,L 87-115,240,34,96,.354,28,65,.431,6,31,.194,13,17,.765,87,49,84,.583,39,59,.661,10,25,.400,7,13,.538,115
264,2021-11-05,WAS,,MEM,W 115-87,240,49,84,.583,39,59,.661,10,25,.400,7,13,.538,115,34,96,.354,28,65,.431,6,31,.194,13,17,.765,87
265,2021-11-06,CHI,,PHI,L 105-114,240,37,92,.402,30,63,.476,7,29,.241,24,30,.800,105,43,81,.531,30,55,.545,13,26,.500,15,19,.789,114
266,2021-11-06,PHI,@,CHI,W 114-105,240,43,81,.531,30,55,.545,13,26,.500,15,19,.789,114,37,92,.402,30,63,.476,7,29,.241,24,30,.800,105
267,2021-11-06,BOS,@,DAL,L 104-107,240,42,86,.488,33,55,.600,9,31,.290,11,16,.688,104,41,78,.526,28,39,.718,13,39,.333,12,14,.857,107
268,2021-11-06,DAL,,BOS,W 107-104,240,41,78,.526,28,39,.718,13,39,.333,12,14,.857,107,42,86,.488,33,55,.600,9,31,.290,11,16,.688,104
269,2021-11-06,DEN,,HOU,W 95-94,240,36,89,.404,27,49,.551,9,40,.225,14,17,.824,95,35,75,.467,27,47,.574,8,28,.286,16,24,.667,94
270,2021-11-06,HOU,@,DEN,L 94-95,240,35,75,.467,27,47,.574,8,28,.286,16,24,.667,94,36,89,.404,27,49,.551,9,40,.225,14,17,.824,95
271,2021-11-06,MIA,,UTA,W 118-115,240,47,78,.603,36,57,.632,11,21,.524,13,17,.765,118,43,83,.518,28,38,.737,15,45,.333,14,19,.737,115
272,2021-11-06,UTA,@,MIA,L 115-118,240,43,83,.518,28,38,.737,15,45,.333,14,19,.737,115,47,78,.603,36,57,.632,11,21,.524,13,17,.765,118
273,2021-11-06,ATL,@,PHO,L 117-121,240,42,97,.433,29,64,.453,13,33,.394,20,23,.870,117,45,88,.511,31,45,.689,14,43,.326,17,21,.810,121
274,2021-11-06,PHO,,ATL,W 121-117,240,45,88,.511,31,45,.689,14,43,.326,17,21,.810,121,42,97,.433,29,64,.453,13,33,.394,20,23,.870,117
275,2021-11-06,LAL,@,POR,L 90-105,240,31,90,.344,22,58,.379,9,32,.281,19,24,.792,90,36,95,.379,21,40,.525,15,55,.273,18,24,.750,105
276,2021-11-06,POR,,LAL,W 105-90,240,36,95,.379,21,40,.525,15,55,.273,18,24,.750,105,31,90,.344,22,58,.379,9,32,.281,19,24,.792,90
277,2021-11-07,GSW,,HOU,W 120-107,240,44,85,.518,29,39,.744,15,46,.326,17,20,.850,120,36,79,.456,26,46,.565,10,33,.303,25,37,.676,107
278,2021-11-07,HOU,@,GSW,L 107-120,240,36,79,.456,26,46,.565,10,33,.303,25,37,.676,107,44,85,.518,29,39,.744,15,46,.326,17,20,.850,120
279,2021-11-07,CHO,@,LAC,L 106-120,240,41,101,.406,31,68,.456,10,33,.303,14,18,.778,106,41,86,.477,23,38,.605,18,48,.375,20,21,.952,120
280,2021-11-07,LAC,,CHO,W 120-106,240,41,86,.477,23,38,.605,18,48,.375,20,21,.952,120,41,101,.406,31,68,.456,10,33,.303,14,18,.778,106
281,2021-11-07,CLE,@,NYK,W 126-109,240,49,90,.544,30,55,.545,19,35,.543,9,11,.818,126,39,85,.459,30,54,.556,9,31,.290,22,24,.917,109
282,2021-11-07,NYK,,CLE,L 109-126,240,39,85,.459,30,54,.556,9,31,.290,22,24,.917,109,49,90,.544,30,55,.545,19,35,.543,9,11,.818,126
283,2021-11-07,OKC,,SAS,W 99-94,240,35,94,.372,23,52,.442,12,42,.286,17,20,.850,99,41,100,.410,35,70,.500,6,30,.200,6,9,.667,94
284,2021-11-07,SAS,@,OKC,L 94-99,240,41,100,.410,35,70,.500,6,30,.200,6,9,.667,94,35,94,.372,23,52,.442,12,42,.286,17,20,.850,99
285,2021-11-07,ORL,,UTA,W 107-100,240,43,87,.494,31,55,.564,12,32,.375,9,11,.818,107,34,89,.382,26,47,.553,8,42,.190,24,29,.828,100
286,2021-11-07,UTA,@,ORL,L 100-107,240,34,89,.382,26,47,.553,8,42,.190,24,29,.828,100,43,87,.494,31,55,.564,12,32,.375,9,11,.818,107
287,2021-11-07,IND,@,SAC,W 94-91,240,37,83,.446,31,58,.534,6,25,.240,14,18,.778,94,31,84,.369,21,50,.420,10,34,.294,19,22,.864,91
288,2021-11-07,SAC,,IND,L 91-94,240,31,84,.369,21,50,.420,10,34,.294,19,22,.864,91,37,83,.446,31,58,.534,6,25,.240,14,18,.778,94
289,2021-11-07,BRK,@,TOR,W 116-103,240,41,80,.513,24,42,.571,17,38,.447,17,20,.850,116,41,87,.471,34,57,.596,7,30,.233,14,18,.778,103
290,2021-11-07,TOR,,BRK,L 103-116,240,41,87,.471,34,57,.596,7,30,.233,14,18,.778,103,41,80,.513,24,42,.571,17,38,.447,17,20,.850,116
291,2021-11-07,MIL,@,WAS,L 94-101,240,37,94,.394,27,58,.466,10,36,.278,10,18,.556,94,41,81,.506,30,54,.556,11,27,.407,8,13,.615,101
292,2021-11-07,WAS,,MIL,W 101-94,240,41,81,.506,30,54,.556,11,27,.407,8,13,.615,101,37,94,.394,27,58,.466,10,36,.278,10,18,.556,94
293,2021-11-08,BRK,@,CHI,L 95-118,240,34,86,.395,23,53,.434,11,33,.333,16,19,.842,95,46,98,.469,37,67,.552,9,31,.290,17,20,.850,118
294,2021-11-08,CHI,,BRK,W 118-95,240,46,98,.469,37,67,.552,9,31,.290,17,20,.850,118,34,86,.395,23,53,.434,11,33,.333,16,19,.842,95
295,2021-11-08,DAL,,NOP,W 108-92,240,43,85,.506,29,50,.580,14,35,.400,8,13,.615,108,37,87,.425,28,53,.528,9,34,.265,9,11,.818,92
296,2021-11-08,NOP,@,DAL,L 92-108,240,37,87,.425,28,53,.528,9,34,.265,9,11,.818,92,43,85,.506,29,50,.580,14,35,.400,8,13,.615,108
297,2021-11-08,DEN,,MIA,W 113-96,240,42,91,.462,30,50,.600,12,41,.293,17,22,.773,113,31,78,.397,18,42,.429,13,36,.361,21,25,.840,96
298,2021-11-08,MIA,@,DEN,L 96-113,240,31,78,.397,18,42,.429,13,36,.361,21,25,.840,96,42,91,.462,30,50,.600,12,41,.293,17,22,.773,113
299,2021-11-08,ATL,@,GSW,L 113-127,240,38,82,.463,21,39,.538,17,43,.395,20,26,.769,113,44,92,.478,26,48,.542,18,44,.409,21,22,.955,127
300,2021-11-08,GSW,,ATL,W 127-113,240,44,92,.478,26,48,.542,18,44,.409,21,22,.955,127,38,82,.463,21,39,.538,17,43,.395,20,26,.769,113
301,2021-11-08,CHO,@,LAL,L 123-126 (OT),265,43,99,.434,29,57,.509,14,42,.333,23,28,.821,123,44,91,.484,31,59,.525,13,32,.406,25,35,.714,126
302,2021-11-08,LAL,,CHO,W 126-123 (OT),265,44,91,.484,31,59,.525,13,32,.406,25,35,.714,126,43,99,.434,29,57,.509,14,42,.333,23,28,.821,123
303,2021-11-08,MEM,,MIN,W 125-118 (OT),265,46,92,.500,35,64,.547,11,28,.393,22,26,.846,125,41,97,.423,24,52,.462,17,45,.378,19,23,.826,118
304,2021-11-08,MIN,@,MEM,L 118-125 (OT),265,41,97,.423,24,52,.462,17,45,.378,19,23,.826,118,46,92,.500,35,64,.547,11,28,.393,22,26,.846,125
305,2021-11-08,NYK,@,PHI,W 103-96,240,40,91,.440,27,51,.529,13,40,.325,10,13,.769,103,35,91,.385,22,51,.431,13,40,.325,13,16,.813,96
306,2021-11-08,PHI,,NYK,L 96-103,240,35,91,.385,22,51,.431,13,40,.325,13,16,.813,96,40,91,.440,27,51,.529,13,40,.325,10,13,.769,103
307,2021-11-08,PHO,@,SAC,W 109-104,240,44,93,.473,32,63,.508,12,30,.400,9,11,.818,109,37,82,.451,27,58,.466,10,24,.417,20,26,.769,104
308,2021-11-08,SAC,,PHO,L 104-109,240,37,82,.451,27,58,.466,10,24,.417,20,26,.769,104,44,93,.473,32,63,.508,12,30,.400,9,11,.818,109
309,2021-11-09,LAC,,POR,W 117-109,240,44,85,.518,28,55,.509,16,30,.533,13,19,.684,117,43,91,.473,29,54,.537,14,37,.378,9,12,.750,109
310,2021-11-09,POR,@,LAC,L 109-117,240,43,91,.473,29,54,.537,14,37,.378,9,12,.750,109,44,85,.518,28,55,.509,16,30,.533,13,19,.684,117
311,2021-11-09,MIL,@,PHI,W 118-109,240,44,95,.463,29,56,.518,15,39,.385,15,21,.714,118,42,103,.408,28,60,.467,14,43,.326,11,12,.917,109
312,2021-11-09,PHI,,MIL,L 109-118,240,42,103,.408,28,60,.467,14,43,.326,11,12,.917,109,44,95,.463,29,56,.518,15,39,.385,15,21,.714,118
313,2021-11-09,ATL,@,UTA,L 98-110,240,37,85,.435,19,50,.380,18,35,.514,6,10,.600,98,41,81,.506,26,43,.605,15,38,.395,13,16,.813,110
314,2021-11-09,UTA,,ATL,W 110-98,240,41,81,.506,26,43,.605,15,38,.395,13,16,.813,110,37,85,.435,19,50,.380,18,35,.514,6,10,.600,98
315,2021-11-10,BOS,,TOR,W 104-88,240,42,94,.447,32,65,.492,10,29,.345,10,15,.667,104,33,77,.429,27,52,.519,6,25,.240,16,19,.842,88
316,2021-11-10,TOR,@,BOS,L 88-104,240,33,77,.429,27,52,.519,6,25,.240,16,19,.842,88,42,94,.447,32,65,.492,10,29,.345,10,15,.667,104
317,2021-11-10,CHI,,DAL,W 117-107,240,45,89,.506,30,58,.517,15,31,.484,12,14,.857,117,38,83,.458,26,50,.520,12,33,.364,19,24,.792,107
318,2021-11-10,DAL,@,CHI,L 107-117,240,38,83,.458,26,50,.520,12,33,.364,19,24,.792,107,45,89,.506,30,58,.517,15,31,.484,12,14,.857,117
319,2021-11-10,CLE,,WAS,L 94-97,240,35,76,.461,26,45,.578,9,31,.290,15,21,.714,94,35,84,.417,25,56,.446,10,28,.357,17,17,1.000,97
320,2021-11-10,WAS,@,CLE,W 97-94,240,35,84,.417,25,56,.446,10,28,.357,17,17,1.000,97,35,76,.461,26,45,.578,9,31,.290,15,21,.714,94
321,2021-11-10,DEN,,IND,W 101-98,240,36,84,.429,24,54,.444,12,30,.400,17,20,.850,101,40,84,.476,29,53,.547,11,31,.355,7,11,.636,98
322,2021-11-10,IND,@,DEN,L 98-101,240,40,84,.476,29,53,.547,11,31,.355,7,11,.636,98,36,84,.429,24,54,.444,12,30,.400,17,20,.850,101
323,2021-11-10,GSW,,MIN,W 123-110,240,40,85,.471,29,45,.644,11,40,.275,32,40,.800,123,39,95,.411,22,51,.431,17,44,.386,15,20,.750,110
324,2021-11-10,MIN,@,GSW,L 110-123,240,39,95,.411,22,51,.431,17,44,.386,15,20,.750,110,40,85,.471,29,45,.644,11,40,.275,32,40,.800,123
325,2021-11-10,DET,@,HOU,W 112-104,240,42,97,.433,26,49,.531,16,48,.333,12,18,.667,112,35,82,.427,23,48,.479,12,34,.353,22,34,.647,104
326,2021-11-10,HOU,,DET,L 104-112,240,35,82,.427,23,48,.479,12,34,.353,22,34,.647,104,42,97,.433,26,49,.531,16,48,.333,12,18,.667,112
327,2021-11-10,LAL,,MIA,W 120-117 (OT),265,46,92,.500,28,54,.519,18,38,.474,10,16,.625,120,40,96,.417,30,59,.508,10,37,.270,27,35,.771,117
328,2021-11-10,MIA,@,LAL,L 117-120 (OT),265,40,96,.417,30,59,.508,10,37,.270,27,35,.771,117,46,92,.500,28,54,.519,18,38,.474,10,16,.625,120
329,2021-11-10,CHO,@,MEM,W 118-108,240,41,90,.456,26,54,.481,15,36,.417,21,24,.875,118,45,107,.421,36,69,.522,9,38,.237,9,15,.600,108
330,2021-11-10,MEM,,CHO,L 108-118,240,45,107,.421,36,69,.522,9,38,.237,9,15,.600,108,41,90,.456,26,54,.481,15,36,.417,21,24,.875,118
331,2021-11-10,NOP,,OKC,L 100-108,240,34,97,.351,25,62,.403,9,35,.257,23,32,.719,100,37,87,.425,27,53,.509,10,34,.294,24,30,.800,108
332,2021-11-10,OKC,@,NOP,W 108-100,240,37,87,.425,27,53,.509,10,34,.294,24,30,.800,108,34,97,.351,25,62,.403,9,35,.257,23,32,.719,100
333,2021-11-10,MIL,@,NYK,W 112-100,240,40,90,.444,14,40,.350,26,50,.520,6,9,.667,112,36,83,.434,20,46,.435,16,37,.432,12,17,.706,100
334,2021-11-10,NYK,,MIL,L 100-112,240,36,83,.434,20,46,.435,16,37,.432,12,17,.706,100,40,90,.444,14,40,.350,26,50,.520,6,9,.667,112
335,2021-11-10,BRK,@,ORL,W 123-90,240,46,91,.505,30,54,.556,16,37,.432,15,17,.882,123,35,92,.380,31,59,.525,4,33,.121,16,24,.667,90
336,2021-11-10,ORL,,BRK,L 90-123,240,35,92,.380,31,59,.525,4,33,.121,16,24,.667,90,46,91,.505,30,54,.556,16,37,.432,15,17,.882,123
337,2021-11-10,PHO,,POR,W 119-109,240,49,94,.521,38,66,.576,11,28,.393,10,12,.833,119,44,91,.484,37,61,.607,7,30,.233,14,16,.875,109
338,2021-11-10,POR,@,PHO,L 109-119,240,44,91,.484,37,61,.607,7,30,.233,14,16,.875,109,49,94,.521,38,66,.576,11,28,.393,10,12,.833,119
339,2021-11-10,SAC,@,SAS,L 117-136,240,47,91,.516,37,55,.673,10,36,.278,13,16,.813,117,49,92,.533,31,60,.517,18,32,.563,20,31,.645,136
340,2021-11-10,SAS,,SAC,W 136-117,240,49,92,.533,31,60,.517,18,32,.563,20,31,.645,136,47,91,.516,37,55,.673,10,36,.278,13,16,.813,117
341,2021-11-11,LAC,,MIA,W 112-109,240,43,91,.473,32,54,.593,11,37,.297,15,17,.882,112,43,97,.443,34,56,.607,9,41,.220,14,17,.824,109
342,2021-11-11,MIA,@,LAC,L 109-112,240,43,97,.443,34,56,.607,9,41,.220,14,17,.824,109,43,91,.473,32,54,.593,11,37,.297,15,17,.882,112
343,2021-11-11,PHI,,TOR,L 109-115,240,40,88,.455,29,54,.537,11,34,.324,18,19,.947,109,42,96,.438,28,63,.444,14,33,.424,17,17,1.000,115
344,2021-11-11,TOR,@,PHI,W 115-109,240,42,96,.438,28,63,.444,14,33,.424,17,17,1.000,115,40,88,.455,29,54,.537,11,34,.324,18,19,.947,109
345,2021-11-11,IND,@,UTA,W 111-100,240,43,96,.448,32,65,.492,11,31,.355,14,19,.737,111,39,83,.470,30,51,.588,9,32,.281,13,23,.565,100
346,2021-11-11,UTA,,IND,L 100-111,240,39,83,.470,30,51,.588,9,32,.281,13,23,.565,100,43,96,.448,32,65,.492,11,31,.355,14,19,.737,111
347,2021-11-12,BOS,,MIL,W 122-113 (OT),265,47,96,.490,35,55,.636,12,41,.293,16,18,.889,122,44,98,.449,28,51,.549,16,47,.340,9,11,.818,113
348,2021-11-12,MIL,@,BOS,L 113-122 (OT),265,44,98,.449,28,51,.549,16,47,.340,9,11,.818,113,47,96,.490,35,55,.636,12,41,.293,16,18,.889,122
349,2021-11-12,CHO,,NYK,W 104-96,240,39,90,.433,29,54,.537,10,36,.278,16,24,.667,104,36,93,.387,23,58,.397,13,35,.371,11,18,.611,96
350,2021-11-12,NYK,@,CHO,L 96-104,240,36,93,.387,23,58,.397,13,35,.371,11,18,.611,96,39,90,.433,29,54,.537,10,36,.278,16,24,.667,104
351,2021-11-12,CLE,,DET,W 98-78,240,39,82,.476,25,41,.610,14,41,.341,6,9,.667,98,29,79,.367,20,49,.408,9,30,.300,11,13,.846,78
352,2021-11-12,DET,@,CLE,L 78-98,240,29,79,.367,20,49,.408,9,30,.300,11,13,.846,78,39,82,.476,25,41,.610,14,41,.341,6,9,.667,98
353,2021-11-12,ATL,@,DEN,L 96-105,240,38,93,.409,33,65,.508,5,28,.179,15,21,.714,96,40,90,.444,30,55,.545,10,35,.286,15,20,.750,105
354,2021-11-12,DEN,,ATL,W 105-96,240,40,90,.444,30,55,.545,10,35,.286,15,20,.750,105,38,93,.409,33,65,.508,5,28,.179,15,21,.714,96
355,2021-11-12,CHI,@,GSW,L 93-119,240,34,78,.436,26,51,.510,8,27,.296,17,22,.773,93,45,93,.484,30,47,.638,15,46,.326,14,16,.875,119
356,2021-11-12,GSW,,CHI,W 119-93,240,45,93,.484,30,47,.638,15,46,.326,14,16,.875,119,34,78,.436,26,51,.510,8,27,.296,17,22,.773,93
357,2021-11-12,HOU,,POR,L 92-104,240,34,85,.400,27,53,.509,7,32,.219,17,27,.630,92,34,87,.391,23,51,.451,11,36,.306,25,31,.806,104
358,2021-11-12,POR,@,HOU,W 104-92,240,34,87,.391,23,51,.451,11,36,.306,25,31,.806,104,34,85,.400,27,53,.509,7,32,.219,17,27,.630,92
359,2021-11-12,LAL,,MIN,L 83-107,240,29,82,.354,20,41,.488,9,41,.220,16,20,.800,83,43,94,.457,31,57,.544,12,37,.324,9,12,.750,107
360,2021-11-12,MIN,@,LAL,W 107-83,240,43,94,.457,31,57,.544,12,37,.324,9,12,.750,107,29,82,.354,20,41,.488,9,41,.220,16,20,.800,83
361,2021-11-12,MEM,,PHO,L 94-119,240,37,98,.378,30,65,.462,7,33,.212,13,23,.565,94,46,94,.489,28,57,.491,18,37,.486,9,9,1.000,119
362,2021-11-12,PHO,@,MEM,W 119-94,240,46,94,.489,28,57,.491,18,37,.486,9,9,1.000,119,37,98,.378,30,65,.462,7,33,.212,13,23,.565,94
363,2021-11-12,BRK,@,NOP,W 120-112,240,41,82,.500,23,48,.479,18,34,.529,20,27,.741,120,43,88,.489,30,56,.536,13,32,.406,13,16,.813,112
364,2021-11-12,NOP,,BRK,L 112-120,240,43,88,.489,30,56,.536,13,32,.406,13,16,.813,112,41,82,.500,23,48,.479,18,34,.529,20,27,.741,120
365,2021-11-12,OKC,,SAC,W 105-103,240,42,99,.424,32,69,.464,10,30,.333,11,15,.733,105,38,95,.400,24,54,.444,14,41,.341,13,17,.765,103
366,2021-11-12,SAC,@,OKC,L 103-105,240,38,95,.400,24,54,.444,14,41,.341,13,17,.765,103,42,99,.424,32,69,.464,10,30,.333,11,15,.733,105
367,2021-11-12,DAL,@,SAS,W 123-109,240,46,100,.460,28,55,.509,18,45,.400,13,19,.684,123,41,84,.488,28,54,.519,13,30,.433,14,20,.700,109
368,2021-11-12,SAS,,DAL,L 109-123,240,41,84,.488,28,54,.519,13,30,.433,14,20,.700,109,46,100,.460,28,55,.509,18,45,.400,13,19,.684,123
369,2021-11-13,BOS,@,CLE,L 89-91,240,33,78,.423,27,55,.491,6,23,.261,17,18,.944,89,31,81,.383,21,43,.488,10,38,.263,19,22,.864,91
370,2021-11-13,CLE,,BOS,W 91-89,240,31,81,.383,21,43,.488,10,38,.263,19,22,.864,91,33,78,.423,27,55,.491,6,23,.261,17,18,.944,89
371,2021-11-13,IND,,PHI,W 118-113,240,47,82,.573,33,54,.611,14,28,.500,10,15,.667,118,38,89,.427,26,66,.394,12,23,.522,25,29,.862,113
372,2021-11-13,PHI,@,IND,L 113-118,240,38,89,.427,26,66,.394,12,23,.522,25,29,.862,113,47,82,.573,33,54,.611,14,28,.500,10,15,.667,118
373,2021-11-13,LAC,,MIN,W 129-102,240,53,99,.535,37,59,.627,16,40,.400,7,9,.778,129,40,102,.392,29,66,.439,11,36,.306,11,16,.688,102
374,2021-11-13,MIN,@,LAC,L 102-129,240,40,102,.392,29,66,.439,11,36,.306,11,16,.688,102,53,99,.535,37,59,.627,16,40,.400,7,9,.778,129
375,2021-11-13,MEM,@,NOP,L 101-112,240,38,88,.432,30,64,.469,8,24,.333,17,21,.810,101,38,79,.481,24,50,.480,14,29,.483,22,25,.880,112
376,2021-11-13,NOP,,MEM,W 112-101,240,38,79,.481,24,50,.480,14,29,.483,22,25,.880,112,38,88,.432,30,64,.469,8,24,.333,17,21,.810,101
377,2021-11-13,ORL,,WAS,L 92-104,240,31,92,.337,18,52,.346,13,40,.325,17,20,.850,92,42,84,.500,30,49,.612,12,35,.343,8,10,.800,104
378,2021-11-13,WAS,@,ORL,W 104-92,240,42,84,.500,30,49,.612,12,35,.343,8,10,.800,104,31,92,.337,18,52,.346,13,40,.325,17,20,.850,92
379,2021-11-13,DET,@,TOR,W 127-121,240,43,79,.544,28,44,.636,15,35,.429,26,30,.867,127,44,87,.506,31,53,.585,13,34,.382,20,31,.645,121
380,2021-11-13,TOR,,DET,L 121-127,240,44,87,.506,31,53,.585,13,34,.382,20,31,.645,121,43,79,.544,28,44,.636,15,35,.429,26,30,.867,127
381,2021-11-13,MIA,@,UTA,W 111-105,240,42,85,.494,29,52,.558,13,33,.394,14,16,.875,111,35,85,.412,18,32,.563,17,53,.321,18,25,.720,105
382,2021-11-13,UTA,,MIA,L 105-111,240,35,85,.412,18,32,.563,17,53,.321,18,25,.720,105,42,85,.494,29,52,.558,13,33,.394,14,16,.875,111
383,2021-11-14,ATL,,MIL,W 120-100,240,47,97,.485,32,62,.516,15,35,.429,11,13,.846,120,38,84,.452,24,43,.558,14,41,.341,10,16,.625,100
384,2021-11-14,MIL,@,ATL,L 100-120,240,38,84,.452,24,43,.558,14,41,.341,10,16,.625,100,47,97,.485,32,62,.516,15,35,.429,11,13,.846,120
385,2021-11-14,CHO,,GSW,W 106-102,240,42,88,.477,28,52,.538,14,36,.389,8,12,.667,106,38,90,.422,29,51,.569,9,39,.231,17,25,.680,102
386,2021-11-14,GSW,@,CHO,L 102-106,240,38,90,.422,29,51,.569,9,39,.231,17,25,.680,102,42,88,.477,28,52,.538,14,36,.389,8,12,.667,106
387,2021-11-14,DEN,,POR,W 124-95,240,47,90,.522,28,50,.560,19,40,.475,11,14,.786,124,35,80,.438,22,41,.537,13,39,.333,12,13,.923,95
388,2021-11-14,POR,@,DEN,L 95-124,240,35,80,.438,22,41,.537,13,39,.333,12,13,.923,95,47,90,.522,28,50,.560,19,40,.475,11,14,.786,124
389,2021-11-14,HOU,,PHO,L 89-115,240,35,85,.412,28,53,.528,7,32,.219,12,18,.667,89,42,97,.433,28,57,.491,14,40,.350,17,20,.850,115
390,2021-11-14,PHO,@,HOU,W 115-89,240,42,97,.433,28,57,.491,14,40,.350,17,20,.850,115,35,85,.412,28,53,.528,7,32,.219,12,18,.667,89
391,2021-11-14,CHI,@,LAC,W 100-90,240,38,86,.442,27,57,.474,11,29,.379,13,14,.929,100,29,81,.358,18,47,.383,11,34,.324,21,21,1.000,90
392,2021-11-14,LAC,,CHI,L 90-100,240,29,81,.358,18,47,.383,11,34,.324,21,21,1.000,90,38,86,.442,27,57,.474,11,29,.379,13,14,.929,100
393,2021-11-14,LAL,,SAS,W 114-106,240,43,83,.518,28,52,.538,15,31,.484,13,17,.765,114,40,90,.444,24,54,.444,16,36,.444,10,15,.667,106
394,2021-11-14,SAS,@,LAL,L 106-114,240,40,90,.444,24,54,.444,16,36,.444,10,15,.667,106,43,83,.518,28,52,.538,15,31,.484,13,17,.765,114
395,2021-11-14,BRK,@,OKC,W 120-96,240,41,82,.500,23,39,.590,18,43,.419,20,21,.952,120,36,90,.400,22,45,.489,14,45,.311,10,11,.909,96
396,2021-11-14,OKC,,BRK,L 96-120,240,36,90,.400,22,45,.489,14,45,.311,10,11,.909,96,41,82,.500,23,39,.590,18,43,.419,20,21,.952,120
397,2021-11-15,ATL,,ORL,W 129-111,240,47,85,.553,33,55,.600,14,30,.467,21,32,.656,129,43,95,.453,27,52,.519,16,43,.372,9,14,.643,111
398,2021-11-15,ORL,@,ATL,L 111-129,240,43,95,.453,27,52,.519,16,43,.372,9,14,.643,111,47,85,.553,33,55,.600,14,30,.467,21,32,.656,129
399,2021-11-15,BOS,@,CLE,W 98-92,240,36,78,.462,26,49,.531,10,29,.345,16,20,.800,98,32,83,.386,16,43,.372,16,40,.400,12,16,.750,92
400,2021-11-15,CLE,,BOS,L 92-98,240,32,83,.386,16,43,.372,16,40,.400,12,16,.750,92,36,78,.462,26,49,.531,10,29,.345,16,20,.800,98
401,2021-11-15,DAL,,DEN,W 111-101,240,45,90,.500,31,54,.574,14,36,.389,7,10,.700,111,40,84,.476,31,52,.596,9,32,.281,12,17,.706,101
402,2021-11-15,DEN,@,DAL,L 101-111,240,40,84,.476,31,52,.596,9,32,.281,12,17,.706,101,45,90,.500,31,54,.574,14,36,.389,7,10,.700,111
403,2021-11-15,DET,,SAC,L 107-129,240,39,96,.406,26,49,.531,13,47,.277,16,17,.941,107,52,98,.531,36,65,.554,16,33,.485,9,11,.818,129
404,2021-11-15,SAC,@,DET,W 129-107,240,52,98,.531,36,65,.554,16,33,.485,9,11,.818,129,39,96,.406,26,49,.531,13,47,.277,16,17,.941,107
405,2021-11-15,CHI,@,LAL,W 121-103,240,49,89,.551,34,55,.618,15,34,.441,8,11,.727,121,36,79,.456,30,47,.638,6,32,.188,25,31,.806,103
406,2021-11-15,LAL,,CHI,L 103-121,240,36,79,.456,30,47,.638,6,32,.188,25,31,.806,103,49,89,.551,34,55,.618,15,34,.441,8,11,.727,121
407,2021-11-15,HOU,@,MEM,L 102-136,240,36,95,.379,25,57,.439,11,38,.289,19,26,.731,102,52,96,.542,36,55,.655,16,41,.390,16,20,.800,136
408,2021-11-15,MEM,,HOU,W 136-102,240,52,96,.542,36,55,.655,16,41,.390,16,20,.800,136,36,95,.379,25,57,.439,11,38,.289,19,26,.731,102
409,2021-11-15,MIN,,PHO,L 96-99,240,31,85,.365,18,41,.439,13,44,.295,21,27,.778,96,32,85,.376,25,54,.463,7,31,.226,28,36,.778,99
410,2021-11-15,PHO,@,MIN,W 99-96,240,32,85,.376,25,54,.463,7,31,.226,28,36,.778,99,31,85,.365,18,41,.439,13,44,.295,21,27,.778,96
411,2021-11-15,IND,@,NYK,L 84-92,240,32,86,.372,24,49,.490,8,37,.216,12,16,.750,84,37,86,.430,26,52,.500,11,34,.324,7,10,.700,92
412,2021-11-15,NYK,,IND,W 92-84,240,37,86,.430,26,52,.500,11,34,.324,7,10,.700,92,32,86,.372,24,49,.490,8,37,.216,12,16,.750,84
413,2021-11-15,MIA,@,OKC,W 103-90,240,37,82,.451,19,42,.452,18,40,.450,11,13,.846,103,34,83,.410,19,42,.452,15,41,.366,7,10,.700,90
414,2021-11-15,OKC,,MIA,L 90-103,240,34,83,.410,19,42,.452,15,41,.366,7,10,.700,90,37,82,.451,19,42,.452,18,40,.450,11,13,.846,103
415,2021-11-15,POR,,TOR,W 118-113,240,46,82,.561,30,46,.652,16,36,.444,10,14,.714,118,41,89,.461,26,56,.464,15,33,.455,16,18,.889,113
416,2021-11-15,TOR,@,POR,L 113-118,240,41,89,.461,26,56,.464,15,33,.455,16,18,.889,113,46,82,.561,30,46,.652,16,36,.444,10,14,.714,118
417,2021-11-15,NOP,@,WAS,L 100-105,240,30,74,.405,19,53,.358,11,21,.524,29,34,.853,100,39,84,.464,29,56,.518,10,28,.357,17,25,.680,105
418,2021-11-15,WAS,,NOP,W 105-100,240,39,84,.464,29,56,.518,10,28,.357,17,25,.680,105,30,74,.405,19,53,.358,11,21,.524,29,34,.853,100
419,2021-11-16,BRK,,GSW,L 99-117,240,34,88,.386,24,52,.462,10,36,.278,21,27,.778,99,41,79,.519,28,39,.718,13,40,.325,22,28,.786,117
420,2021-11-16,GSW,@,BRK,W 117-99,240,41,79,.519,28,39,.718,13,40,.325,22,28,.786,117,34,88,.386,24,52,.462,10,36,.278,21,27,.778,99
421,2021-11-16,LAC,,SAS,W 106-92,240,37,85,.435,25,47,.532,12,38,.316,20,22,.909,106,41,95,.432,36,73,.493,5,22,.227,5,7,.714,92
422,2021-11-16,SAS,@,LAC,L 92-106,240,41,95,.432,36,73,.493,5,22,.227,5,7,.714,92,37,85,.435,25,47,.532,12,38,.316,20,22,.909,106
423,2021-11-16,PHI,@,UTA,L 85-120,240,33,90,.367,27,61,.443,6,29,.207,13,17,.765,85,46,89,.517,30,51,.588,16,38,.421,12,19,.632,120
424,2021-11-16,UTA,,PHI,W 120-85,240,46,89,.517,30,51,.588,16,38,.421,12,19,.632,120,33,90,.367,27,61,.443,6,29,.207,13,17,.765,85
425,2021-11-17,ATL,,BOS,W 110-99,240,41,81,.506,28,44,.636,13,37,.351,15,18,.833,110,37,84,.440,26,43,.605,11,41,.268,14,17,.824,99
426,2021-11-17,BOS,@,ATL,L 99-110,240,37,84,.440,26,43,.605,11,41,.268,14,17,.824,99,41,81,.506,28,44,.636,13,37,.351,15,18,.833,110
427,2021-11-17,BRK,,CLE,W 109-99,240,38,83,.458,26,51,.510,12,32,.375,21,25,.840,109,35,89,.393,24,45,.533,11,44,.250,18,21,.857,99
428,2021-11-17,CLE,@,BRK,L 99-109,240,35,89,.393,24,45,.533,11,44,.250,18,21,.857,99,38,83,.458,26,51,.510,12,32,.375,21,25,.840,109
429,2021-11-17,CHO,,WAS,W 97-87,240,42,96,.438,32,64,.500,10,32,.313,3,6,.500,97,33,90,.367,25,48,.521,8,42,.190,13,16,.813,87
430,2021-11-17,WAS,@,CHO,L 87-97,240,33,90,.367,25,48,.521,8,42,.190,13,16,.813,87,42,96,.438,32,64,.500,10,32,.313,3,6,.500,97
431,2021-11-17,DET,,IND,W 97-89,240,34,80,.425,26,52,.500,8,28,.286,21,28,.750,97,33,79,.418,24,42,.571,9,37,.243,14,19,.737,89
432,2021-11-17,IND,@,DET,L 89-97,240,33,79,.418,24,42,.571,9,37,.243,14,19,.737,89,34,80,.425,26,52,.500,8,28,.286,21,28,.750,97
433,2021-11-17,MIA,,NOP,W 113-98,240,42,87,.483,27,47,.574,15,40,.375,14,17,.824,113,33,75,.440,23,40,.575,10,35,.286,22,28,.786,98
434,2021-11-17,NOP,@,MIA,L 98-113,240,33,75,.440,23,40,.575,10,35,.286,22,28,.786,98,42,87,.483,27,47,.574,15,40,.375,14,17,.824,113
435,2021-11-17,LAL,@,MIL,L 102-109,240,40,96,.417,28,53,.528,12,43,.279,10,12,.833,102,40,87,.460,28,50,.560,12,37,.324,17,24,.708,109
436,2021-11-17,MIL,,LAL,W 109-102,240,40,87,.460,28,50,.560,12,37,.324,17,24,.708,109,40,96,.417,28,53,.528,12,43,.279,10,12,.833,102
437,2021-11-17,MIN,,SAC,W 107-97,240,41,82,.500,31,46,.674,10,36,.278,15,18,.833,107,34,93,.366,24,55,.436,10,38,.263,19,25,.760,97
438,2021-11-17,SAC,@,MIN,L 97-107,240,34,93,.366,24,55,.436,10,38,.263,19,25,.760,97,41,82,.500,31,46,.674,10,36,.278,15,18,.833,107
439,2021-11-17,NYK,,ORL,L 98-104,240,37,88,.420,21,39,.538,16,49,.327,8,12,.667,98,39,96,.406,28,58,.483,11,38,.289,15,18,.833,104
440,2021-11-17,ORL,@,NYK,W 104-98,240,39,96,.406,28,58,.483,11,38,.289,15,18,.833,104,37,88,.420,21,39,.538,16,49,.327,8,12,.667,98
441,2021-11-17,HOU,@,OKC,L 89-101,240,32,90,.356,20,48,.417,12,42,.286,13,19,.684,89,41,92,.446,31,53,.585,10,39,.256,9,16,.563,101
442,2021-11-17,OKC,,HOU,W 101-89,240,41,92,.446,31,53,.585,10,39,.256,9,16,.563,101,32,90,.356,20,48,.417,12,42,.286,13,19,.684,89
443,2021-11-17,DAL,@,PHO,L 98-105,240,38,91,.418,22,59,.373,16,32,.500,6,6,1.000,98,41,93,.441,28,54,.519,13,39,.333,10,14,.714,105
444,2021-11-17,PHO,,DAL,W 105-98,240,41,93,.441,28,54,.519,13,39,.333,10,14,.714,105,38,91,.418,22,59,.373,16,32,.500,6,6,1.000,98
445,2021-11-17,CHI,@,POR,L 107-112,240,39,83,.470,26,54,.481,13,29,.448,16,20,.800,107,37,84,.440,26,53,.491,11,31,.355,27,28,.964,112
446,2021-11-17,POR,,CHI,W 112-107,240,37,84,.440,26,53,.491,11,31,.355,27,28,.964,112,39,83,.470,26,54,.481,13,29,.448,16,20,.800,107
447,2021-11-18,CLE,,GSW,L 89-104,240,34,80,.425,22,41,.537,12,39,.308,9,16,.563,89,41,83,.494,26,40,.650,15,43,.349,7,8,.875,104
448,2021-11-18,GSW,@,CLE,W 104-89,240,41,83,.494,26,40,.650,15,43,.349,7,8,.875,104,34,80,.425,22,41,.537,12,39,.308,9,16,.563,89
449,2021-11-18,DEN,,PHI,L 89-103,240,32,89,.360,20,53,.377,12,36,.333,13,16,.813,89,43,85,.506,32,56,.571,11,29,.379,6,12,.500,103
450,2021-11-18,PHI,@,DEN,W 103-89,240,43,85,.506,32,56,.571,11,29,.379,6,12,.500,103,32,89,.360,20,53,.377,12,36,.333,13,16,.813,89
451,2021-11-18,LAC,@,MEM,L 108-120,240,42,90,.467,26,51,.510,16,39,.410,8,8,1.000,108,52,96,.542,41,70,.586,11,26,.423,5,6,.833,120
452,2021-11-18,MEM,,LAC,W 120-108,240,52,96,.542,41,70,.586,11,26,.423,5,6,.833,120,42,90,.467,26,51,.510,16,39,.410,8,8,1.000,108
453,2021-11-18,MIA,,WAS,W 112-97,240,41,82,.500,31,56,.554,10,26,.385,20,24,.833,112,38,77,.494,23,41,.561,15,36,.417,6,10,.600,97
454,2021-11-18,WAS,@,MIA,L 97-112,240,38,77,.494,23,41,.561,15,36,.417,6,10,.600,97,41,82,.500,31,56,.554,10,26,.385,20,24,.833,112
455,2021-11-18,MIN,,SAS,W 115-90,240,41,86,.477,20,37,.541,21,49,.429,12,15,.800,115,35,84,.417,29,52,.558,6,32,.188,14,19,.737,90
456,2021-11-18,SAS,@,MIN,L 90-115,240,35,84,.417,29,52,.558,6,32,.188,14,19,.737,90,41,86,.477,20,37,.541,21,49,.429,12,15,.800,115
457,2021-11-18,TOR,@,UTA,L 103-119,240,39,94,.415,29,56,.518,10,38,.263,15,17,.882,103,44,80,.550,25,34,.735,19,46,.413,12,13,.923,119
458,2021-11-18,UTA,,TOR,W 119-103,240,44,80,.550,25,34,.735,19,46,.413,12,13,.923,119,39,94,.415,29,56,.518,10,38,.263,15,17,.882,103
459,2021-11-19,BOS,,LAL,W 130-108,240,44,88,.500,33,58,.569,11,30,.367,31,38,.816,130,39,84,.464,27,54,.500,12,30,.400,18,24,.750,108
460,2021-11-19,LAL,@,BOS,L 108-130,240,39,84,.464,27,54,.500,12,30,.400,18,24,.750,108,44,88,.500,33,58,.569,11,30,.367,31,38,.816,130
461,2021-11-19,BRK,,ORL,W 115-113,240,41,91,.451,31,58,.534,10,33,.303,23,25,.920,115,40,89,.449,26,51,.510,14,38,.368,19,25,.760,113
462,2021-11-19,ORL,@,BRK,L 113-115,240,40,89,.449,26,51,.510,14,38,.368,19,25,.760,113,41,91,.451,31,58,.534,10,33,.303,23,25,.920,115
463,2021-11-19,CHO,,IND,W 121-118,240,44,81,.543,32,50,.640,12,31,.387,21,28,.750,121,41,88,.466,30,52,.577,11,36,.306,25,32,.781,118
464,2021-11-19,IND,@,CHO,L 118-121,240,41,88,.466,30,52,.577,11,36,.306,25,32,.781,118,44,81,.543,32,50,.640,12,31,.387,21,28,.750,121
465,2021-11-19,CHI,@,DEN,W 114-108,240,41,93,.441,33,62,.532,8,31,.258,24,24,1.000,114,39,82,.476,25,45,.556,14,37,.378,16,20,.800,108
466,2021-11-19,DEN,,CHI,L 108-114,240,39,82,.476,25,45,.556,14,37,.378,16,20,.800,108,41,93,.441,33,62,.532,8,31,.258,24,24,1.000,114
467,2021-11-19,DET,,GSW,L 102-105,240,32,80,.400,18,38,.474,14,42,.333,24,30,.800,102,38,80,.475,26,50,.520,12,30,.400,17,21,.810,105
468,2021-11-19,GSW,@,DET,W 105-102,240,38,80,.475,26,50,.520,12,30,.400,17,21,.810,105,32,80,.400,18,38,.474,14,42,.333,24,30,.800,102
469,2021-11-19,MIL,,OKC,W 96-89,240,31,83,.373,19,42,.452,12,41,.293,22,26,.846,96,32,91,.352,20,43,.465,12,48,.250,13,21,.619,89
470,2021-11-19,OKC,@,MIL,L 89-96,240,32,91,.352,20,43,.465,12,48,.250,13,21,.619,89,31,83,.373,19,42,.452,12,41,.293,22,26,.846,96
471,2021-11-19,LAC,@,NOP,L 81-94,240,34,90,.378,25,53,.472,9,37,.243,4,5,.800,81,38,87,.437,25,57,.439,13,30,.433,5,8,.625,94
472,2021-11-19,NOP,,LAC,W 94-81,240,38,87,.437,25,57,.439,13,30,.433,5,8,.625,94,34,90,.378,25,53,.472,9,37,.243,4,5,.800,81
473,2021-11-19,DAL,@,PHO,L 104-112,240,37,90,.411,25,50,.500,12,40,.300,18,23,.783,104,44,85,.518,30,56,.536,14,29,.483,10,14,.714,112
474,2021-11-19,PHO,,DAL,W 112-104,240,44,85,.518,30,56,.536,14,29,.483,10,14,.714,112,37,90,.411,25,50,.500,12,40,.300,18,23,.783,104
475,2021-11-19,SAC,,TOR,L 89-108,240,32,84,.381,23,47,.489,9,37,.243,16,25,.640,89,38,84,.452,26,53,.491,12,31,.387,20,24,.833,108
476,2021-11-19,TOR,@,SAC,W 108-89,240,38,84,.452,26,53,.491,12,31,.387,20,24,.833,108,32,84,.381,23,47,.489,9,37,.243,16,25,.640,89
477,2021-11-20,ATL,,CHO,W 115-105,240,43,82,.524,31,48,.646,12,34,.353,17,21,.810,115,43,102,.422,33,62,.532,10,40,.250,9,15,.600,105
478,2021-11-20,CHO,@,ATL,L 105-115,240,43,102,.422,33,62,.532,10,40,.250,9,15,.600,105,43,82,.524,31,48,.646,12,34,.353,17,21,.810,115
479,2021-11-20,BOS,,OKC,W 111-105,240,41,88,.466,24,49,.490,17,39,.436,12,14,.857,111,39,96,.406,21,54,.389,18,42,.429,9,16,.563,105
480,2021-11-20,OKC,@,BOS,L 105-111,240,39,96,.406,21,54,.389,18,42,.429,9,16,.563,105,41,88,.466,24,49,.490,17,39,.436,12,14,.857,111
481,2021-11-20,IND,,NOP,W 111-94,240,42,91,.462,28,53,.528,14,38,.368,13,18,.722,111,35,88,.398,29,70,.414,6,18,.333,18,19,.947,94
482,2021-11-20,NOP,@,IND,L 94-111,240,35,88,.398,29,70,.414,6,18,.333,18,19,.947,94,42,91,.462,28,53,.528,14,38,.368,13,18,.722,111
483,2021-11-20,MIL,,ORL,W 117-108,240,37,82,.451,18,42,.429,19,40,.475,24,37,.649,117,39,98,.398,20,47,.426,19,51,.373,11,14,.786,108
484,2021-11-20,ORL,@,MIL,L 108-117,240,39,98,.398,20,47,.426,19,51,.373,11,14,.786,108,37,82,.451,18,42,.429,19,40,.475,24,37,.649,117
485,2021-11-20,MEM,@,MIN,L 95-138,240,29,83,.349,20,51,.392,9,32,.281,28,35,.800,95,49,91,.538,29,50,.580,20,41,.488,20,28,.714,138
486,2021-11-20,MIN,,MEM,W 138-95,240,49,91,.538,29,50,.580,20,41,.488,20,28,.714,138,29,83,.349,20,51,.392,9,32,.281,28,35,.800,95
487,2021-11-20,HOU,@,NYK,L 99-106,240,38,84,.452,28,45,.622,10,39,.256,13,22,.591,99,33,78,.423,15,37,.405,18,41,.439,22,26,.846,106
488,2021-11-20,NYK,,HOU,W 106-99,240,33,78,.423,15,37,.405,18,41,.439,22,26,.846,106,38,84,.452,28,45,.622,10,39,.256,13,22,.591,99
489,2021-11-20,PHI,@,POR,L 111-118,240,41,81,.506,31,53,.585,10,28,.357,19,21,.905,111,40,80,.500,25,46,.543,15,34,.441,23,23,1.000,118
490,2021-11-20,POR,,PHI,W 118-111,240,40,80,.500,25,46,.543,15,34,.441,23,23,1.000,118,41,81,.506,31,53,.585,10,28,.357,19,21,.905,111
491,2021-11-20,SAC,,UTA,L 105-123,240,41,91,.451,31,60,.517,10,31,.323,13,21,.619,105,46,91,.505,29,52,.558,17,39,.436,14,17,.824,123
492,2021-11-20,UTA,@,SAC,W 123-105,240,46,91,.505,29,52,.558,17,39,.436,14,17,.824,123,41,91,.451,31,60,.517,10,31,.323,13,21,.619,105
493,2021-11-20,MIA,@,WAS,L 100-103,240,38,81,.469,31,54,.574,7,27,.259,17,20,.850,100,36,74,.486,25,44,.568,11,30,.367,20,23,.870,103
494,2021-11-20,WAS,,MIA,W 103-100,240,36,74,.486,25,44,.568,11,30,.367,20,23,.870,103,38,81,.469,31,54,.574,7,27,.259,17,20,.850,100
495,2021-11-21,CHI,,NYK,W 109-103,240,37,88,.420,26,59,.441,11,29,.379,24,27,.889,109,35,84,.417,28,57,.491,7,27,.259,26,31,.839,103
496,2021-11-21,NYK,@,CHI,L 103-109,240,35,84,.417,28,57,.491,7,27,.259,26,31,.839,103,37,88,.420,26,59,.441,11,29,.379,24,27,.889,109
497,2021-11-21,DET,,LAL,L 116-121,240,43,97,.443,29,57,.509,14,40,.350,16,21,.762,116,45,92,.489,35,61,.574,10,31,.323,21,27,.778,121
498,2021-11-21,LAL,@,DET,W 121-116,240,45,92,.489,35,61,.574,10,31,.323,21,27,.778,121,43,97,.443,29,57,.509,14,40,.350,16,21,.762,116
499,2021-11-21,GSW,,TOR,W 119-104,240,39,79,.494,17,34,.500,22,45,.489,19,24,.792,119,39,99,.394,24,62,.387,15,37,.405,11,20,.550,104
500,2021-11-21,TOR,@,GSW,L 104-119,240,39,99,.394,24,62,.387,15,37,.405,11,20,.550,104,39,79,.494,17,34,.500,22,45,.489,19,24,.792,119
501,2021-11-21,DAL,@,LAC,L 91-97,240,34,83,.410,28,53,.528,6,30,.200,17,18,.944,91,36,75,.480,24,46,.522,12,29,.414,13,18,.722,97
502,2021-11-21,LAC,,DAL,W 97-91,240,36,75,.480,24,46,.522,12,29,.414,13,18,.722,97,34,83,.410,28,53,.528,6,30,.200,17,18,.944,91
503,2021-11-21,DEN,@,PHO,L 97-126,240,33,90,.367,22,52,.423,11,38,.289,20,28,.714,97,46,87,.529,35,51,.686,11,36,.306,23,26,.885,126
504,2021-11-21,PHO,,DEN,W 126-97,240,46,87,.529,35,51,.686,11,36,.306,23,26,.885,126,33,90,.367,22,52,.423,11,38,.289,20,28,.714,97
505,2021-11-22,ATL,,OKC,W 113-101,240,42,87,.483,28,53,.528,14,34,.412,15,16,.938,113,39,97,.402,29,59,.492,10,38,.263,13,14,.929,101
506,2021-11-22,OKC,@,ATL,L 101-113,240,39,97,.402,29,59,.492,10,38,.263,13,14,.929,101,42,87,.483,28,53,.528,14,34,.412,15,16,.938,113
507,2021-11-22,BOS,,HOU,W 108-90,240,39,92,.424,27,57,.474,12,35,.343,18,19,.947,108,31,83,.373,20,41,.488,11,42,.262,17,24,.708,90
508,2021-11-22,HOU,@,BOS,L 90-108,240,31,83,.373,20,41,.488,11,42,.262,17,24,.708,90,39,92,.424,27,57,.474,12,35,.343,18,19,.947,108
509,2021-11-22,CHI,,IND,L 77-109,240,31,85,.365,25,57,.439,6,28,.214,9,15,.600,77,40,90,.444,27,59,.458,13,31,.419,16,18,.889,109
510,2021-11-22,IND,@,CHI,W 109-77,240,40,90,.444,27,59,.458,13,31,.419,16,18,.889,109,31,85,.365,25,57,.439,6,28,.214,9,15,.600,77
511,2021-11-22,BRK,@,CLE,W 117-112,240,45,95,.474,34,60,.567,11,35,.314,16,18,.889,117,36,93,.387,22,49,.449,14,44,.318,26,29,.897,112
512,2021-11-22,CLE,,BRK,L 112-117,240,36,93,.387,22,49,.449,14,44,.318,26,29,.897,112,45,95,.474,34,60,.567,11,35,.314,16,18,.889,117
513,2021-11-22,MIL,,ORL,W 123-92,240,44,94,.468,26,49,.531,18,45,.400,17,24,.708,123,34,93,.366,23,52,.442,11,41,.268,13,18,.722,92
514,2021-11-22,ORL,@,MIL,L 92-123,240,34,93,.366,23,52,.442,11,41,.268,13,18,.722,92,44,94,.468,26,49,.531,18,45,.400,17,24,.708,123
515,2021-11-22,MIN,@,NOP,W 110-96,240,40,100,.400,30,56,.536,10,44,.227,20,28,.714,110,37,88,.420,31,56,.554,6,32,.188,16,18,.889,96
516,2021-11-22,NOP,,MIN,L 96-110,240,37,88,.420,31,56,.554,6,32,.188,16,18,.889,96,40,100,.400,30,56,.536,10,44,.227,20,28,.714,110
517,2021-11-22,PHI,@,SAC,W 102-94,240,36,85,.424,27,53,.509,9,32,.281,21,27,.778,102,33,80,.413,26,49,.531,7,31,.226,21,29,.724,94
518,2021-11-22,SAC,,PHI,L 94-102,240,33,80,.413,26,49,.531,7,31,.226,21,29,.724,94,36,85,.424,27,53,.509,9,32,.281,21,27,.778,102
519,2021-11-22,PHO,@,SAS,W 115-111,240,45,88,.511,33,61,.541,12,27,.444,13,16,.813,115,49,93,.527,44,73,.603,5,20,.250,8,16,.500,111
520,2021-11-22,SAS,,PHO,L 111-115,240,49,93,.527,44,73,.603,5,20,.250,8,16,.500,111,45,88,.511,33,61,.541,12,27,.444,13,16,.813,115
521,2021-11-22,MEM,@,UTA,W 119-118,240,42,95,.442,29,60,.483,13,35,.371,22,27,.815,119,41,87,.471,24,44,.545,17,43,.395,19,25,.760,118
522,2021-11-22,UTA,,MEM,L 118-119,240,41,87,.471,24,44,.545,17,43,.395,19,25,.760,118,42,95,.442,29,60,.483,13,35,.371,22,27,.815,119
523,2021-11-22,CHO,@,WAS,W 109-103,240,40,91,.440,25,60,.417,15,31,.484,14,24,.583,109,36,94,.383,27,57,.474,9,37,.243,22,27,.815,103
524,2021-11-22,WAS,,CHO,L 103-109,240,36,94,.383,27,57,.474,9,37,.243,22,27,.815,103,40,91,.440,25,60,.417,15,31,.484,14,24,.583,109
525,2021-11-23,DET,,MIA,L 92-100,240,35,84,.417,25,46,.543,10,38,.263,12,14,.857,92,35,76,.461,26,47,.553,9,29,.310,21,29,.724,100
526,2021-11-23,MIA,@,DET,W 100-92,240,35,76,.461,26,47,.553,9,29,.310,21,29,.724,100,35,84,.417,25,46,.543,10,38,.263,12,14,.857,92
527,2021-11-23,DAL,@,LAC,W 112-104 (OT),265,39,89,.438,27,50,.540,12,39,.308,22,27,.815,112,35,85,.412,25,53,.472,10,32,.313,24,29,.828,104
528,2021-11-23,LAC,,DAL,L 104-112 (OT),265,35,85,.412,25,53,.472,10,32,.313,24,29,.828,104,39,89,.438,27,50,.540,12,39,.308,22,27,.815,112
529,2021-11-23,LAL,@,NYK,L 100-106,240,34,91,.374,23,55,.418,11,36,.306,21,30,.700,100,37,82,.451,22,48,.458,15,34,.441,17,21,.810,106
530,2021-11-23,NYK,,LAL,W 106-100,240,37,82,.451,22,48,.458,15,34,.441,17,21,.810,106,34,91,.374,23,55,.418,11,36,.306,21,30,.700,100
531,2021-11-23,DEN,@,POR,L 100-119,240,38,78,.487,23,45,.511,15,33,.455,9,11,.818,100,45,88,.511,30,49,.612,15,39,.385,14,20,.700,119
532,2021-11-23,POR,,DEN,W 119-100,240,45,88,.511,30,49,.612,15,39,.385,14,20,.700,119,38,78,.487,23,45,.511,15,33,.455,9,11,.818,100
533,2021-11-24,BOS,,BRK,L 104-123,240,34,91,.374,23,43,.535,11,48,.229,25,28,.893,104,43,85,.506,29,50,.580,14,35,.400,23,30,.767,123
534,2021-11-24,BRK,@,BOS,W 123-104,240,43,85,.506,29,50,.580,14,35,.400,23,30,.767,123,34,91,.374,23,43,.535,11,48,.229,25,28,.893,104
535,2021-11-24,CLE,,PHO,L 115-120,240,43,97,.443,31,58,.534,12,39,.308,17,25,.680,115,45,86,.523,37,64,.578,8,22,.364,22,28,.786,120
536,2021-11-24,PHO,@,CLE,W 120-115,240,45,86,.523,37,64,.578,8,22,.364,22,28,.786,120,43,97,.443,31,58,.534,12,39,.308,17,25,.680,115
537,2021-11-24,GSW,,PHI,W 116-96,240,42,80,.525,27,42,.643,15,38,.395,17,24,.708,116,34,80,.425,26,52,.500,8,28,.286,20,22,.909,96
538,2021-11-24,PHI,@,GSW,L 96-116,240,34,80,.425,26,52,.500,8,28,.286,20,22,.909,96,42,80,.525,27,42,.643,15,38,.395,17,24,.708,116
539,2021-11-24,CHI,@,HOU,L 113-118,240,44,96,.458,29,61,.475,15,35,.429,10,12,.833,113,42,84,.500,25,48,.521,17,36,.472,17,22,.773,118
540,2021-11-24,HOU,,CHI,W 118-113,240,42,84,.500,25,48,.521,17,36,.472,17,22,.773,118,44,96,.458,29,61,.475,15,35,.429,10,12,.833,113
541,2021-11-24,IND,,LAL,L 116-124 (OT),265,42,104,.404,29,58,.500,13,46,.283,19,24,.792,116,42,95,.442,27,58,.466,15,37,.405,25,29,.862,124
542,2021-11-24,LAL,@,IND,W 124-116 (OT),265,42,95,.442,27,58,.466,15,37,.405,25,29,.862,124,42,104,.404,29,58,.500,13,46,.283,19,24,.792,116
543,2021-11-24,MEM,,TOR,L 113-126,240,42,82,.512,33,53,.623,9,29,.310,20,26,.769,113,47,89,.528,33,59,.559,14,30,.467,18,21,.857,126
544,2021-11-24,TOR,@,MEM,W 126-113,240,47,89,.528,33,59,.559,14,30,.467,18,21,.857,126,42,82,.512,33,53,.623,9,29,.310,20,26,.769,113
545,2021-11-24,DET,@,MIL,L 93-114,240,34,95,.358,23,50,.460,11,45,.244,14,19,.737,93,42,87,.483,27,51,.529,15,36,.417,15,17,.882,114
546,2021-11-24,MIL,,DET,W 114-93,240,42,87,.483,27,51,.529,15,36,.417,15,17,.882,114,34,95,.358,23,50,.460,11,45,.244,14,19,.737,93
547,2021-11-24,MIA,@,MIN,L 101-113,240,33,74,.446,18,32,.563,15,42,.357,20,29,.690,101,38,93,.409,20,38,.526,18,55,.327,19,21,.905,113
548,2021-11-24,MIN,,MIA,W 113-101,240,38,93,.409,20,38,.526,18,55,.327,19,21,.905,113,33,74,.446,18,32,.563,15,42,.357,20,29,.690,101
549,2021-11-24,NOP,,WAS,W 127-102,240,44,96,.458,32,67,.478,12,29,.414,27,32,.844,127,36,84,.429,29,53,.547,7,31,.226,23,36,.639,102
550,2021-11-24,WAS,@,NOP,L 102-127,240,36,84,.429,29,53,.547,7,31,.226,23,36,.639,102,44,96,.458,32,67,.478,12,29,.414,27,32,.844,127
551,2021-11-24,OKC,,UTA,L 104-110,240,37,82,.451,22,46,.478,15,36,.417,15,22,.682,104,39,86,.453,24,39,.615,15,47,.319,17,20,.850,110
552,2021-11-24,UTA,@,OKC,W 110-104,240,39,86,.453,24,39,.615,15,47,.319,17,20,.850,110,37,82,.451,22,46,.478,15,36,.417,15,22,.682,104
553,2021-11-24,CHO,@,ORL,W 106-99,240,39,93,.419,27,53,.509,12,40,.300,16,21,.762,106,38,93,.409,23,51,.451,15,42,.357,8,10,.800,99
554,2021-11-24,ORL,,CHO,L 99-106,240,38,93,.409,23,51,.451,15,42,.357,8,10,.800,99,39,93,.419,27,53,.509,12,40,.300,16,21,.762,106
555,2021-11-24,POR,@,SAC,L 121-125,240,44,94,.468,32,56,.571,12,38,.316,21,25,.840,121,45,86,.523,33,53,.623,12,33,.364,23,34,.676,125
556,2021-11-24,SAC,,POR,W 125-121,240,45,86,.523,33,53,.623,12,33,.364,23,34,.676,125,44,94,.468,32,56,.571,12,38,.316,21,25,.840,121
557,2021-11-24,ATL,@,SAS,W 124-106,240,45,88,.511,33,62,.532,12,26,.462,22,24,.917,124,43,100,.430,31,67,.463,12,33,.364,8,10,.800,106
558,2021-11-24,SAS,,ATL,L 106-124,240,43,100,.430,31,67,.463,12,33,.364,8,10,.800,106,45,88,.511,33,62,.532,12,26,.462,22,24,.917,124
559,2021-11-26,CHO,,MIN,W 133-115,240,49,88,.557,26,48,.542,23,40,.575,12,15,.800,133,45,100,.450,34,65,.523,11,35,.314,14,19,.737,115
560,2021-11-26,MIN,@,CHO,L 115-133,240,45,100,.450,34,65,.523,11,35,.314,14,19,.737,115,49,88,.557,26,48,.542,23,40,.575,12,15,.800,133
561,2021-11-26,DEN,,MIL,L 109-120,240,40,92,.435,23,45,.511,17,47,.362,12,14,.857,109,46,73,.630,30,40,.750,16,33,.485,12,20,.600,120
562,2021-11-26,MIL,@,DEN,W 120-109,240,46,73,.630,30,40,.750,16,33,.485,12,20,.600,120,40,92,.435,23,45,.511,17,47,.362,12,14,.857,109
563,2021-11-26,GSW,,POR,W 118-103,240,47,87,.540,35,50,.700,12,37,.324,12,16,.750,118,36,86,.419,23,48,.479,13,38,.342,18,23,.783,103
564,2021-11-26,POR,@,GSW,L 103-118,240,36,86,.419,23,48,.479,13,38,.342,18,23,.783,103,47,87,.540,35,50,.700,12,37,.324,12,16,.750,118
565,2021-11-26,IND,,TOR,W 114-97,240,47,97,.485,36,58,.621,11,39,.282,9,11,.818,114,37,89,.416,30,59,.508,7,30,.233,16,22,.727,97
566,2021-11-26,TOR,@,IND,L 97-114,240,37,89,.416,30,59,.508,7,30,.233,16,22,.727,97,47,97,.485,36,58,.621,11,39,.282,9,11,.818,114
567,2021-11-26,DET,@,LAC,L 96-107,240,33,90,.367,25,57,.439,8,33,.242,22,26,.846,96,39,91,.429,28,53,.528,11,38,.289,18,19,.947,107
568,2021-11-26,LAC,,DET,W 107-96,240,39,91,.429,28,53,.528,11,38,.289,18,19,.947,107,33,90,.367,25,57,.439,8,33,.242,22,26,.846,96
569,2021-11-26,LAL,,SAC,L 137-141 (3OT),315,51,102,.500,36,58,.621,15,44,.341,20,28,.714,137,54,120,.450,40,75,.533,14,45,.311,19,29,.655,141
570,2021-11-26,SAC,@,LAL,W 141-137 (3OT),315,54,120,.450,40,75,.533,14,45,.311,19,29,.655,141,51,102,.500,36,58,.621,15,44,.341,20,28,.714,137
571,2021-11-26,ATL,@,MEM,W 132-100,240,52,89,.584,39,62,.629,13,27,.481,15,21,.714,132,37,91,.407,25,53,.472,12,38,.316,14,19,.737,100
572,2021-11-26,MEM,,ATL,L 100-132,240,37,91,.407,25,53,.472,12,38,.316,14,19,.737,100,52,89,.584,39,62,.629,13,27,.481,15,21,.714,132
573,2021-11-26,NYK,,PHO,L 97-118,240,34,92,.370,22,53,.415,12,39,.308,17,22,.773,97,44,79,.557,31,51,.608,13,28,.464,17,21,.810,118
574,2021-11-26,PHO,@,NYK,W 118-97,240,44,79,.557,31,51,.608,13,28,.464,17,21,.810,118,34,92,.370,22,53,.415,12,39,.308,17,22,.773,97
575,2021-11-26,OKC,,WAS,L 99-101,240,38,94,.404,27,61,.443,11,33,.333,12,14,.857,99,38,79,.481,28,50,.560,10,29,.345,15,15,1.000,101
576,2021-11-26,WAS,@,OKC,W 101-99,240,38,79,.481,28,50,.560,10,29,.345,15,15,1.000,101,38,94,.404,27,61,.443,11,33,.333,12,14,.857,99
577,2021-11-26,CHI,@,ORL,W 123-88,240,48,86,.558,31,52,.596,17,34,.500,10,16,.625,123,30,80,.375,23,48,.479,7,32,.219,21,30,.700,88
578,2021-11-26,ORL,,CHI,L 88-123,240,30,80,.375,23,48,.479,7,32,.219,21,30,.700,88,48,86,.558,31,52,.596,17,34,.500,10,16,.625,123
579,2021-11-26,BOS,@,SAS,L 88-96,240,34,92,.370,24,58,.414,10,34,.294,10,15,.667,88,38,87,.437,32,63,.508,6,24,.250,14,19,.737,96
580,2021-11-26,SAS,,BOS,W 96-88,240,38,87,.437,32,63,.508,6,24,.250,14,19,.737,96,34,92,.370,24,58,.414,10,34,.294,10,15,.667,88
581,2021-11-26,NOP,@,UTA,W 98-97,240,38,89,.427,27,62,.435,11,27,.407,11,13,.846,98,36,80,.450,23,47,.489,13,33,.394,12,18,.667,97
582,2021-11-26,UTA,,NOP,L 97-98,240,36,80,.450,23,47,.489,13,33,.394,12,18,.667,97,38,89,.427,27,62,.435,11,27,.407,11,13,.846,98
583,2021-11-27,ATL,,NYK,L 90-99,240,33,93,.355,24,56,.429,9,37,.243,15,20,.750,90,36,82,.439,25,53,.472,11,29,.379,16,22,.727,99
584,2021-11-27,NYK,@,ATL,W 99-90,240,36,82,.439,25,53,.472,11,29,.379,16,22,.727,99,33,93,.355,24,56,.429,9,37,.243,15,20,.750,90
585,2021-11-27,BRK,,PHO,L 107-113,240,42,84,.500,35,61,.574,7,23,.304,16,21,.762,107,41,92,.446,28,54,.519,13,38,.342,18,21,.857,113
586,2021-11-27,PHO,@,BRK,W 113-107,240,41,92,.446,28,54,.519,13,38,.342,18,21,.857,113,42,84,.500,35,61,.574,7,23,.304,16,21,.762,107
587,2021-11-27,CHI,,MIA,L 104-107,240,38,81,.469,27,42,.643,11,39,.282,17,21,.810,104,37,86,.430,23,46,.500,14,40,.350,19,22,.864,107
588,2021-11-27,MIA,@,CHI,W 107-104,240,37,86,.430,23,46,.500,14,40,.350,19,22,.864,107,38,81,.469,27,42,.643,11,39,.282,17,21,.810,104
589,2021-11-27,CLE,,ORL,W 105-92,240,41,90,.456,27,51,.529,14,39,.359,9,12,.750,105,35,88,.398,27,56,.482,8,32,.250,14,23,.609,92
590,2021-11-27,ORL,@,CLE,L 92-105,240,35,88,.398,27,56,.482,8,32,.250,14,23,.609,92,41,90,.456,27,51,.529,14,39,.359,9,12,.750,105
591,2021-11-27,DAL,,WAS,L 114-120,240,42,89,.472,28,51,.549,14,38,.368,16,22,.727,114,45,78,.577,36,54,.667,9,24,.375,21,26,.808,120
592,2021-11-27,WAS,@,DAL,W 120-114,240,45,78,.577,36,54,.667,9,24,.375,21,26,.808,120,42,89,.472,28,51,.549,14,38,.368,16,22,.727,114
593,2021-11-27,CHO,@,HOU,L 143-146 (OT),265,48,103,.466,28,53,.528,20,50,.400,27,30,.900,143,51,95,.537,28,46,.609,23,49,.469,21,31,.677,146
594,2021-11-27,HOU,,CHO,W 146-143 (OT),265,51,95,.537,28,46,.609,23,49,.469,21,31,.677,146,48,103,.466,28,53,.528,20,50,.400,27,30,.900,143
595,2021-11-27,MIN,@,PHI,W 121-120 (2OT),290,48,96,.500,34,60,.567,14,36,.389,11,16,.688,121,39,93,.419,27,59,.458,12,34,.353,30,39,.769,120
596,2021-11-27,PHI,,MIN,L 120-121 (2OT),290,39,93,.419,27,59,.458,12,34,.353,30,39,.769,120,48,96,.500,34,60,.567,14,36,.389,11,16,.688,121
597,2021-11-27,NOP,@,UTA,L 105-127,240,40,93,.430,32,58,.552,8,35,.229,17,21,.810,105,45,80,.563,25,45,.556,20,35,.571,17,22,.773,127
598,2021-11-27,UTA,,NOP,W 127-105,240,45,80,.563,25,45,.556,20,35,.571,17,22,.773,127,40,93,.430,32,58,.552,8,35,.229,17,21,.810,105
599,2021-11-28,IND,,MIL,L 100-118,240,38,92,.413,26,47,.553,12,45,.267,12,16,.750,100,46,90,.511,38,55,.691,8,35,.229,18,22,.818,118
600,2021-11-28,MIL,@,IND,W 118-100,240,46,90,.511,38,55,.691,8,35,.229,18,22,.818,118,38,92,.413,26,47,.553,12,45,.267,12,16,.750,100
601,2021-11-28,GSW,@,LAC,W 105-90,240,38,86,.442,21,46,.457,17,40,.425,12,22,.545,105,32,80,.400,23,52,.442,9,28,.321,17,25,.680,90
602,2021-11-28,LAC,,GSW,L 90-105,240,32,80,.400,23,52,.442,9,28,.321,17,25,.680,90,38,86,.442,21,46,.457,17,40,.425,12,22,.545,105
603,2021-11-28,DET,@,LAL,L 106-110,240,38,89,.427,25,56,.446,13,33,.394,17,19,.895,106,43,86,.500,34,54,.630,9,32,.281,15,25,.600,110
604,2021-11-28,LAL,,DET,W 110-106,240,43,86,.500,34,54,.630,9,32,.281,15,25,.600,110,38,89,.427,25,56,.446,13,33,.394,17,19,.895,106
605,2021-11-28,MEM,,SAC,W 128-101,240,50,104,.481,37,65,.569,13,39,.333,15,20,.750,128,33,97,.340,24,55,.436,9,42,.214,26,37,.703,101
606,2021-11-28,SAC,@,MEM,L 101-128,240,33,97,.340,24,55,.436,9,42,.214,26,37,.703,101,50,104,.481,37,65,.569,13,39,.333,15,20,.750,128
607,2021-11-28,BOS,@,TOR,W 109-97,240,34,82,.415,22,48,.458,12,34,.353,29,31,.935,109,35,93,.376,22,51,.431,13,42,.310,14,16,.875,97
608,2021-11-28,TOR,,BOS,L 97-109,240,35,93,.376,22,51,.431,13,42,.310,14,16,.875,97,34,82,.415,22,48,.458,12,34,.353,29,31,.935,109
609,2021-11-29,CHI,,CHO,W 133-119,240,53,89,.596,39,59,.661,14,30,.467,13,19,.684,133,42,88,.477,24,49,.490,18,39,.462,17,21,.810,119
610,2021-11-29,CHO,@,CHI,L 119-133,240,42,88,.477,24,49,.490,18,39,.462,17,21,.810,119,53,89,.596,39,59,.661,14,30,.467,13,19,.684,133
611,2021-11-29,CLE,@,DAL,W 114-96,240,45,80,.563,35,61,.574,10,19,.526,14,18,.778,114,39,89,.438,27,50,.540,12,39,.308,6,15,.400,96
612,2021-11-29,DAL,,CLE,L 96-114,240,39,89,.438,27,50,.540,12,39,.308,6,15,.400,96,45,80,.563,35,61,.574,10,19,.526,14,18,.778,114
613,2021-11-29,HOU,,OKC,W 102-89,240,40,96,.417,25,50,.500,15,46,.326,7,11,.636,102,31,87,.356,24,44,.545,7,43,.163,20,26,.769,89
614,2021-11-29,OKC,@,HOU,L 89-102,240,31,87,.356,24,44,.545,7,43,.163,20,26,.769,89,40,96,.417,25,50,.500,15,46,.326,7,11,.636,102
615,2021-11-29,LAC,,NOP,L 104-123,240,37,72,.514,23,36,.639,14,36,.389,16,21,.762,104,48,94,.511,34,59,.576,14,35,.400,13,16,.813,123
616,2021-11-29,NOP,@,LAC,W 123-104,240,48,94,.511,34,59,.576,14,35,.400,13,16,.813,123,37,72,.514,23,36,.639,14,36,.389,16,21,.762,104
617,2021-11-29,DEN,@,MIA,W 120-111,240,43,74,.581,25,39,.641,18,35,.514,16,21,.762,120,43,91,.473,28,47,.596,15,44,.341,10,15,.667,111
618,2021-11-29,MIA,,DEN,L 111-120,240,43,91,.473,28,47,.596,15,44,.341,10,15,.667,111,43,74,.581,25,39,.641,18,35,.514,16,21,.762,120
619,2021-11-29,IND,@,MIN,L 98-100,240,36,91,.396,27,54,.500,9,37,.243,17,21,.810,98,36,82,.439,27,47,.574,9,35,.257,19,26,.731,100
620,2021-11-29,MIN,,IND,W 100-98,240,36,82,.439,27,47,.574,9,35,.257,19,26,.731,100,36,91,.396,27,54,.500,9,37,.243,17,21,.810,98
621,2021-11-29,ORL,@,PHI,L 96-101,240,37,90,.411,29,57,.509,8,33,.242,14,18,.778,96,39,97,.402,29,64,.453,10,33,.303,13,18,.722,101
622,2021-11-29,PHI,,ORL,W 101-96,240,39,97,.402,29,64,.453,10,33,.303,13,18,.722,101,37,90,.411,29,57,.509,8,33,.242,14,18,.778,96
623,2021-11-29,SAS,,WAS,W 116-99,240,49,92,.533,41,74,.554,8,18,.444,10,16,.625,116,41,92,.446,32,61,.525,9,31,.290,8,13,.615,99
624,2021-11-29,WAS,@,SAS,L 99-116,240,41,92,.446,32,61,.525,9,31,.290,8,13,.615,99,49,92,.533,41,74,.554,8,18,.444,10,16,.625,116
625,2021-11-29,POR,@,UTA,L 107-129,240,42,91,.462,31,60,.517,11,31,.355,12,17,.706,107,47,89,.528,28,43,.651,19,46,.413,16,23,.696,129
626,2021-11-29,UTA,,POR,W 129-107,240,47,89,.528,28,43,.651,19,46,.413,16,23,.696,129,42,91,.462,31,60,.517,11,31,.355,12,17,.706,107
627,2021-11-30,BRK,,NYK,W 112-110,240,41,85,.482,33,57,.579,8,28,.286,22,25,.880,112,44,91,.484,33,59,.559,11,32,.344,11,12,.917,110
628,2021-11-30,NYK,@,BRK,L 110-112,240,44,91,.484,33,59,.559,11,32,.344,11,12,.917,110,41,85,.482,33,57,.579,8,28,.286,22,25,.880,112
629,2021-11-30,GSW,@,PHO,L 96-104,240,36,86,.419,22,46,.478,14,40,.350,10,14,.714,96,43,87,.494,31,57,.544,12,30,.400,6,11,.545,104
630,2021-11-30,PHO,,GSW,W 104-96,240,43,87,.494,31,57,.544,12,30,.400,6,11,.545,104,36,86,.419,22,46,.478,14,40,.350,10,14,.714,96
631,2021-11-30,DET,@,POR,L 92-110,240,29,76,.382,20,41,.488,9,35,.257,25,30,.833,92,41,96,.427,27,54,.500,14,42,.333,14,18,.778,110
632,2021-11-30,POR,,DET,W 110-92,240,41,96,.427,27,54,.500,14,42,.333,14,18,.778,110,29,76,.382,20,41,.488,9,35,.257,25,30,.833,92
633,2021-11-30,LAL,@,SAC,W 117-92,240,46,92,.500,35,64,.547,11,28,.393,14,20,.700,117,35,79,.443,29,50,.580,6,29,.207,16,22,.727,92
634,2021-11-30,SAC,,LAL,L 92-117,240,35,79,.443,29,50,.580,6,29,.207,16,22,.727,92,46,92,.500,35,64,.547,11,28,.393,14,20,.700,117
635,2021-11-30,MEM,@,TOR,W 98-91,240,36,93,.387,26,59,.441,10,34,.294,16,19,.842,98,36,91,.396,26,52,.500,10,39,.256,9,12,.750,91
636,2021-11-30,TOR,,MEM,L 91-98,240,36,91,.396,26,52,.500,10,39,.256,9,12,.750,91,36,93,.387,26,59,.441,10,34,.294,16,19,.842,98
637,2021-12-01,BOS,,PHI,W 88-87,240,33,79,.418,22,51,.431,11,28,.393,11,15,.733,88,33,89,.371,25,58,.431,8,31,.258,13,17,.765,87
638,2021-12-01,PHI,@,BOS,L 87-88,240,33,89,.371,25,58,.431,8,31,.258,13,17,.765,87,33,79,.418,22,51,.431,11,28,.393,11,15,.733,88
639,2021-12-01,ATL,@,IND,W 114-111,240,44,86,.512,28,53,.528,16,33,.485,10,12,.833,114,44,90,.489,34,57,.596,10,33,.303,13,16,.813,111
640,2021-12-01,IND,,ATL,L 111-114,240,44,90,.489,34,57,.596,10,33,.303,13,16,.813,111,44,86,.512,28,53,.528,16,33,.485,10,12,.833,114
641,2021-12-01,LAC,,SAC,L 115-124,240,47,100,.470,38,69,.551,9,31,.290,12,16,.750,115,46,88,.523,31,50,.620,15,38,.395,17,20,.850,124
642,2021-12-01,SAC,@,LAC,W 124-115,240,46,88,.523,31,50,.620,15,38,.395,17,20,.850,124,47,100,.470,38,69,.551,9,31,.290,12,16,.750,115
643,2021-12-01,CLE,@,MIA,W 111-85,240,37,68,.544,21,37,.568,16,31,.516,21,23,.913,111,32,85,.376,20,48,.417,12,37,.324,9,13,.692,85
644,2021-12-01,MIA,,CLE,L 85-111,240,32,85,.376,20,48,.417,12,37,.324,9,13,.692,85,37,68,.544,21,37,.568,16,31,.516,21,23,.913,111
645,2021-12-01,CHO,@,MIL,L 125-127,240,43,87,.494,22,36,.611,21,51,.412,18,21,.857,125,46,94,.489,32,58,.552,14,36,.389,21,26,.808,127
646,2021-12-01,MIL,,CHO,W 127-125,240,46,94,.489,32,58,.552,14,36,.389,21,26,.808,127,43,87,.494,22,36,.611,21,51,.412,18,21,.857,125
647,2021-12-01,DAL,@,NOP,W 139-107,240,57,83,.687,39,49,.796,18,34,.529,7,9,.778,139,40,89,.449,27,52,.519,13,37,.351,14,16,.875,107
648,2021-12-01,NOP,,DAL,L 107-139,240,40,89,.449,27,52,.519,13,37,.351,14,16,.875,107,57,83,.687,39,49,.796,18,34,.529,7,9,.778,139
649,2021-12-01,HOU,@,OKC,W 114-110,240,40,79,.506,25,42,.595,15,37,.405,19,22,.864,114,40,85,.471,32,53,.604,8,32,.250,22,29,.759,110
650,2021-12-01,OKC,,HOU,L 110-114,240,40,85,.471,32,53,.604,8,32,.250,22,29,.759,110,40,79,.506,25,42,.595,15,37,.405,19,22,.864,114
651,2021-12-01,DEN,@,ORL,L 103-108,240,39,80,.488,29,46,.630,10,34,.294,15,21,.714,103,44,81,.543,38,54,.704,6,27,.222,14,19,.737,108
652,2021-12-01,ORL,,DEN,W 108-103,240,44,81,.543,38,54,.704,6,27,.222,14,19,.737,108,39,80,.488,29,46,.630,10,34,.294,15,21,.714,103
653,2021-12-01,MIN,@,WAS,L 107-115,240,37,88,.420,26,51,.510,11,37,.297,22,26,.846,107,45,91,.495,35,59,.593,10,32,.313,15,21,.714,115
654,2021-12-01,WAS,,MIN,W 115-107,240,45,91,.495,35,59,.593,10,32,.313,15,21,.714,115,37,88,.420,26,51,.510,11,37,.297,22,26,.846,107
655,2021-12-02,MEM,,OKC,W 152-79,240,60,96,.625,41,60,.683,19,36,.528,13,18,.722,152,25,76,.329,14,38,.368,11,38,.289,18,22,.818,79
656,2021-12-02,OKC,@,MEM,L 79-152,240,25,76,.329,14,38,.368,11,38,.289,18,22,.818,79,60,96,.625,41,60,.683,19,36,.528,13,18,.722,152
657,2021-12-02,CHI,@,NYK,W 119-115,240,44,89,.494,33,60,.550,11,29,.379,20,21,.952,119,42,82,.512,33,56,.589,9,26,.346,22,27,.815,115
658,2021-12-02,NYK,,CHI,L 115-119,240,42,82,.512,33,56,.589,9,26,.346,22,27,.815,115,44,89,.494,33,60,.550,11,29,.379,20,21,.952,119
659,2021-12-02,DET,@,PHO,L 103-114,240,36,80,.450,25,53,.472,11,27,.407,20,26,.769,103,43,79,.544,31,58,.534,12,21,.571,16,23,.696,114
660,2021-12-02,PHO,,DET,W 114-103,240,43,79,.544,31,58,.534,12,21,.571,16,23,.696,114,36,80,.450,25,53,.472,11,27,.407,20,26,.769,103
661,2021-12-02,POR,,SAS,L 83-114,240,29,82,.354,17,48,.354,12,34,.353,13,17,.765,83,44,91,.484,30,55,.545,14,36,.389,12,16,.750,114
662,2021-12-02,SAS,@,POR,W 114-83,240,44,91,.484,30,55,.545,14,36,.389,12,16,.750,114,29,82,.354,17,48,.354,12,34,.353,13,17,.765,83
663,2021-12-02,MIL,@,TOR,L 93-97,240,32,85,.376,21,54,.389,11,31,.355,18,25,.720,93,37,88,.420,23,48,.479,14,40,.350,9,14,.643,97
664,2021-12-02,TOR,,MIL,W 97-93,240,37,88,.420,23,48,.479,14,40,.350,9,14,.643,97,32,85,.376,21,54,.389,11,31,.355,18,25,.720,93
665,2021-12-03,ATL,,PHI,L 96-98,240,31,76,.408,21,48,.438,10,28,.357,24,30,.800,96,38,81,.469,29,59,.492,9,22,.409,13,17,.765,98
666,2021-12-03,PHI,@,ATL,W 98-96,240,38,81,.469,29,59,.492,9,22,.409,13,17,.765,98,31,76,.408,21,48,.438,10,28,.357,24,30,.800,96
667,2021-12-03,BRK,,MIN,W 110-105,240,36,76,.474,30,53,.566,6,23,.261,32,41,.780,110,36,93,.387,23,51,.451,13,42,.310,20,24,.833,105
668,2021-12-03,MIN,@,BRK,L 105-110,240,36,93,.387,23,51,.451,13,42,.310,20,24,.833,105,36,76,.474,30,53,.566,6,23,.261,32,41,.780,110
669,2021-12-03,DAL,,NOP,L 91-107,240,32,79,.405,22,45,.489,10,34,.294,17,26,.654,91,37,90,.411,25,60,.417,12,30,.400,21,28,.750,107
670,2021-12-03,NOP,@,DAL,W 107-91,240,37,90,.411,25,60,.417,12,30,.400,21,28,.750,107,32,79,.405,22,45,.489,10,34,.294,17,26,.654,91
671,2021-12-03,GSW,,PHO,W 118-96,240,45,92,.489,26,53,.491,19,39,.487,9,12,.750,118,31,81,.383,23,59,.390,8,22,.364,26,35,.743,96
672,2021-12-03,PHO,@,GSW,L 96-118,240,31,81,.383,23,59,.390,8,22,.364,26,35,.743,96,45,92,.489,26,53,.491,19,39,.487,9,12,.750,118
673,2021-12-03,HOU,,ORL,W 118-116,240,44,92,.478,27,45,.600,17,47,.362,13,15,.867,118,42,86,.488,29,49,.592,13,37,.351,19,21,.905,116
674,2021-12-03,ORL,@,HOU,L 116-118,240,42,86,.488,29,49,.592,13,37,.351,19,21,.905,116,44,92,.478,27,45,.600,17,47,.362,13,15,.867,118
675,2021-12-03,IND,,MIA,L 104-113,240,35,80,.438,26,44,.591,9,36,.250,25,33,.758,104,43,81,.531,27,47,.574,16,34,.471,11,13,.846,113
676,2021-12-03,MIA,@,IND,W 113-104,240,43,81,.531,27,47,.574,16,34,.471,11,13,.846,113,35,80,.438,26,44,.591,9,36,.250,25,33,.758,104
677,2021-12-03,LAC,@,LAL,W 119-115,240,41,81,.506,25,46,.543,16,35,.457,21,24,.875,119,45,90,.500,33,57,.579,12,33,.364,13,21,.619,115
678,2021-12-03,LAL,,LAC,L 115-119,240,45,90,.500,33,57,.579,12,33,.364,13,21,.619,115,41,81,.506,25,46,.543,16,35,.457,21,24,.875,119
679,2021-12-03,BOS,@,UTA,L 130-137,240,47,91,.516,33,52,.635,14,39,.359,22,22,1.000,130,45,81,.556,18,30,.600,27,51,.529,20,23,.870,137
680,2021-12-03,UTA,,BOS,W 137-130,240,45,81,.556,18,30,.600,27,51,.529,20,23,.870,137,47,91,.516,33,52,.635,14,39,.359,22,22,1.000,130
681,2021-12-03,CLE,@,WAS,W 116-101,240,42,89,.472,29,59,.492,13,30,.433,19,25,.760,116,38,82,.463,28,51,.549,10,31,.323,15,19,.789,101
682,2021-12-03,WAS,,CLE,L 101-116,240,38,82,.463,28,51,.549,10,31,.323,15,19,.789,101,42,89,.472,29,59,.492,13,30,.433,19,25,.760,116
683,2021-12-04,BRK,,CHI,L 107-111,240,46,111,.414,38,86,.442,8,25,.320,7,9,.778,107,41,86,.477,31,55,.564,10,31,.323,19,27,.704,111
684,2021-12-04,CHI,@,BRK,W 111-107,240,41,86,.477,31,55,.564,10,31,.323,19,27,.704,111,46,111,.414,38,86,.442,8,25,.320,7,9,.778,107
685,2021-12-04,DAL,,MEM,L 90-97,240,31,92,.337,16,49,.327,15,43,.349,13,19,.684,90,37,76,.487,28,50,.560,9,26,.346,14,24,.583,97
686,2021-12-04,MEM,@,DAL,W 97-90,240,37,76,.487,28,50,.560,9,26,.346,14,24,.583,97,31,92,.337,16,49,.327,15,43,.349,13,19,.684,90
687,2021-12-04,GSW,,SAS,L 107-112,240,40,90,.444,27,51,.529,13,39,.333,14,21,.667,107,42,88,.477,30,53,.566,12,35,.343,16,19,.842,112
688,2021-12-04,SAS,@,GSW,W 112-107,240,42,88,.477,30,53,.566,12,35,.343,16,19,.842,112,40,90,.444,27,51,.529,13,39,.333,14,21,.667,107
689,2021-12-04,MIA,@,MIL,L 102-124,240,34,84,.405,17,41,.415,17,43,.395,17,24,.708,102,44,98,.449,26,48,.542,18,50,.360,18,20,.900,124
690,2021-12-04,MIL,,MIA,W 124-102,240,44,98,.449,26,48,.542,18,50,.360,18,20,.900,124,34,84,.405,17,41,.415,17,43,.395,17,24,.708,102
691,2021-12-04,DEN,@,NYK,W 113-99,240,44,84,.524,24,41,.585,20,43,.465,5,5,1.000,113,35,88,.398,23,48,.479,12,40,.300,17,21,.810,99
692,2021-12-04,NYK,,DEN,L 99-113,240,35,88,.398,23,48,.479,12,40,.300,17,21,.810,99,44,84,.524,24,41,.585,20,43,.465,5,5,1.000,113
693,2021-12-04,BOS,@,POR,W 145-117,240,49,87,.563,28,50,.560,21,37,.568,26,29,.897,145,42,89,.472,34,60,.567,8,29,.276,25,32,.781,117
694,2021-12-04,POR,,BOS,L 117-145,240,42,89,.472,34,60,.567,8,29,.276,25,32,.781,117,49,87,.563,28,50,.560,21,37,.568,26,29,.897,145
695,2021-12-04,LAC,@,SAC,L 99-104,240,34,89,.382,21,55,.382,13,34,.382,18,27,.667,99,36,86,.419,24,52,.462,12,34,.353,20,25,.800,104
696,2021-12-04,SAC,,LAC,W 104-99,240,36,86,.419,24,52,.462,12,34,.353,20,25,.800,104,34,89,.382,21,55,.382,13,34,.382,18,27,.667,99
697,2021-12-05,ATL,,CHO,L 127-130,240,48,93,.516,31,56,.554,17,37,.459,14,18,.778,127,46,86,.535,29,49,.592,17,37,.459,21,28,.750,130
698,2021-12-05,CHO,@,ATL,W 130-127,240,46,86,.535,29,49,.592,17,37,.459,21,28,.750,130,48,93,.516,31,56,.554,17,37,.459,14,18,.778,127
699,2021-12-05,CLE,,UTA,L 108-109,240,42,91,.462,28,53,.528,14,38,.368,10,13,.769,108,40,90,.444,20,42,.476,20,48,.417,9,10,.900,109
700,2021-12-05,UTA,@,CLE,W 109-108,240,40,90,.444,20,42,.476,20,48,.417,9,10,.900,109,42,91,.462,28,53,.528,14,38,.368,10,13,.769,108
701,2021-12-05,HOU,,NOP,W 118-108,240,39,79,.494,22,39,.564,17,40,.425,23,29,.793,118,40,94,.426,30,56,.536,10,38,.263,18,25,.720,108
702,2021-12-05,NOP,@,HOU,L 108-118,240,40,94,.426,30,56,.536,10,38,.263,18,25,.720,108,39,79,.494,22,39,.564,17,40,.425,23,29,.793,118
703,2021-12-05,TOR,,WAS,W 102-90,240,38,85,.447,30,62,.484,8,23,.348,18,24,.750,102,30,73,.411,22,48,.458,8,25,.320,22,29,.759,90
704,2021-12-05,WAS,@,TOR,L 90-102,240,30,73,.411,22,48,.458,8,25,.320,22,29,.759,90,38,85,.447,30,62,.484,8,23,.348,18,24,.750,102
705,2021-12-06,CHI,,DEN,W 109-97,240,41,91,.451,28,56,.500,13,35,.371,14,20,.700,109,38,96,.396,27,64,.422,11,32,.344,10,15,.667,97
706,2021-12-06,DEN,@,CHI,L 97-109,240,38,96,.396,27,64,.422,11,32,.344,10,15,.667,97,41,91,.451,28,56,.500,13,35,.371,14,20,.700,109
707,2021-12-06,CHO,,PHI,L 124-127 (OT),265,48,107,.449,32,61,.525,16,46,.348,12,17,.706,124,46,87,.529,31,51,.608,15,36,.417,20,27,.741,127
708,2021-12-06,PHI,@,CHO,W 127-124 (OT),265,46,87,.529,31,51,.608,15,36,.417,20,27,.741,127,48,107,.449,32,61,.525,16,46,.348,12,17,.706,124
709,2021-12-06,DET,,OKC,L 103-114,240,41,99,.414,25,58,.431,16,41,.390,5,6,.833,103,41,82,.500,32,57,.561,9,25,.360,23,30,.767,114
710,2021-12-06,OKC,@,DET,W 114-103,240,41,82,.500,32,57,.561,9,25,.360,23,30,.767,114,41,99,.414,25,58,.431,16,41,.390,5,6,.833,103
711,2021-12-06,GSW,,ORL,W 126-95,240,43,87,.494,23,47,.489,20,40,.500,20,29,.690,126,33,76,.434,22,38,.579,11,38,.289,18,22,.818,95
712,2021-12-06,ORL,@,GSW,L 95-126,240,33,76,.434,22,38,.579,11,38,.289,18,22,.818,95,43,87,.494,23,47,.489,20,40,.500,20,29,.690,126
713,2021-12-06,IND,,WAS,W 116-110,240,43,82,.524,34,59,.576,9,23,.391,21,22,.955,116,43,81,.531,36,66,.545,7,15,.467,17,21,.810,110
714,2021-12-06,WAS,@,IND,L 110-116,240,43,81,.531,36,66,.545,7,15,.467,17,21,.810,110,43,82,.524,34,59,.576,9,23,.391,21,22,.955,116
715,2021-12-06,MEM,@,MIA,W 105-90,240,38,89,.427,25,56,.446,13,33,.394,16,21,.762,105,35,76,.461,29,54,.537,6,22,.273,14,17,.824,90
716,2021-12-06,MIA,,MEM,L 90-105,240,35,76,.461,29,54,.537,6,22,.273,14,17,.824,90,38,89,.427,25,56,.446,13,33,.394,16,21,.762,105
717,2021-12-06,CLE,@,MIL,L 104-112,240,35,90,.389,20,44,.455,15,46,.326,19,20,.950,104,40,86,.465,27,54,.500,13,32,.406,19,24,.792,112
718,2021-12-06,MIL,,CLE,W 112-104,240,40,86,.465,27,54,.500,13,32,.406,19,24,.792,112,35,90,.389,20,44,.455,15,46,.326,19,20,.950,104
719,2021-12-06,ATL,@,MIN,W 121-110,240,40,90,.444,15,41,.366,25,49,.510,16,19,.842,121,39,98,.398,22,58,.379,17,40,.425,15,19,.789,110
720,2021-12-06,MIN,,ATL,L 110-121,240,39,98,.398,22,58,.379,17,40,.425,15,19,.789,110,40,90,.444,15,41,.366,25,49,.510,16,19,.842,121
721,2021-12-06,PHO,,SAS,W 108-104,240,43,94,.457,33,65,.508,10,29,.345,12,18,.667,108,40,93,.430,29,64,.453,11,29,.379,13,19,.684,104
722,2021-12-06,SAS,@,PHO,L 104-108,240,40,93,.430,29,64,.453,11,29,.379,13,19,.684,104,43,94,.457,33,65,.508,10,29,.345,12,18,.667,108
723,2021-12-06,LAC,@,POR,W 102-90,240,41,92,.446,30,56,.536,11,36,.306,9,14,.643,102,35,79,.443,30,57,.526,5,22,.227,15,20,.750,90
724,2021-12-06,POR,,LAC,L 90-102,240,35,79,.443,30,57,.526,5,22,.227,15,20,.750,90,41,92,.446,30,56,.536,11,36,.306,9,14,.643,102
725,2021-12-07,BRK,@,DAL,W 102-99,240,42,83,.506,34,57,.596,8,26,.308,10,13,.769,102,36,90,.400,27,44,.614,9,46,.196,18,22,.818,99
726,2021-12-07,DAL,,BRK,L 99-102,240,36,90,.400,27,44,.614,9,46,.196,18,22,.818,99,42,83,.506,34,57,.596,8,26,.308,10,13,.769,102
727,2021-12-07,BOS,@,LAL,L 102-117,240,36,82,.439,26,49,.531,10,33,.303,20,29,.690,102,48,93,.516,40,66,.606,8,27,.296,13,17,.765,117
728,2021-12-07,LAL,,BOS,W 117-102,240,48,93,.516,40,66,.606,8,27,.296,13,17,.765,117,36,82,.439,26,49,.531,10,33,.303,20,29,.690,102
729,2021-12-07,NYK,@,SAS,W 121-109,240,43,91,.473,25,53,.472,18,38,.474,17,19,.895,121,41,92,.446,29,61,.475,12,31,.387,15,20,.750,109
730,2021-12-07,SAS,,NYK,L 109-121,240,41,92,.446,29,61,.475,12,31,.387,15,20,.750,109,43,91,.473,25,53,.472,18,38,.474,17,19,.895,121
731,2021-12-08,CHO,,PHI,L 106-110,240,39,80,.488,29,51,.569,10,29,.345,18,21,.857,106,36,75,.480,23,41,.561,13,34,.382,25,30,.833,110
732,2021-12-08,PHI,@,CHO,W 110-106,240,36,75,.480,23,41,.561,13,34,.382,25,30,.833,110,39,80,.488,29,51,.569,10,29,.345,18,21,.857,106
733,2021-12-08,CHI,@,CLE,L 92-115,240,35,84,.417,28,58,.483,7,26,.269,15,21,.714,92,44,80,.550,31,52,.596,13,28,.464,14,16,.875,115
734,2021-12-08,CLE,,CHI,W 115-92,240,44,80,.550,31,52,.596,13,28,.464,14,16,.875,115,35,84,.417,28,58,.483,7,26,.269,15,21,.714,92
735,2021-12-08,DET,,WAS,L 116-119 (OT),265,37,79,.468,24,55,.436,13,24,.542,29,35,.829,116,42,88,.477,30,56,.536,12,32,.375,23,28,.821,119
736,2021-12-08,WAS,@,DET,W 119-116 (OT),265,42,88,.477,30,56,.536,12,32,.375,23,28,.821,119,37,79,.468,24,55,.436,13,24,.542,29,35,.829,116
737,2021-12-08,GSW,,POR,W 104-94,240,33,83,.398,19,37,.514,14,46,.304,24,31,.774,104,33,80,.413,25,50,.500,8,30,.267,20,28,.714,94
738,2021-12-08,POR,@,GSW,L 94-104,240,33,80,.413,25,50,.500,8,30,.267,20,28,.714,94,33,83,.398,19,37,.514,14,46,.304,24,31,.774,104
739,2021-12-08,BRK,@,HOU,L 104-114,240,35,89,.393,27,56,.482,8,33,.242,26,31,.839,104,40,81,.494,26,40,.650,14,41,.341,20,29,.690,114
740,2021-12-08,HOU,,BRK,W 114-104,240,40,81,.494,26,40,.650,14,41,.341,20,29,.690,114,35,89,.393,27,56,.482,8,33,.242,26,31,.839,104
741,2021-12-08,IND,,NYK,W 122-102,240,46,86,.535,36,59,.610,10,27,.370,20,25,.800,122,36,86,.419,27,56,.482,9,30,.300,21,23,.913,102
742,2021-12-08,NYK,@,IND,L 102-122,240,36,86,.419,27,56,.482,9,30,.300,21,23,.913,102,46,86,.535,36,59,.610,10,27,.370,20,25,.800,122
743,2021-12-08,BOS,@,LAC,L 111-114,240,41,86,.477,31,54,.574,10,32,.313,19,21,.905,111,40,85,.471,26,53,.491,14,32,.438,20,22,.909,114
744,2021-12-08,LAC,,BOS,W 114-111,240,40,85,.471,26,53,.491,14,32,.438,20,22,.909,114,41,86,.477,31,54,.574,10,32,.313,19,21,.905,111
745,2021-12-08,DAL,@,MEM,W 104-96,240,37,77,.481,25,44,.568,12,33,.364,18,23,.783,104,36,90,.400,27,59,.458,9,31,.290,15,25,.600,96
746,2021-12-08,MEM,,DAL,L 96-104,240,36,90,.400,27,59,.458,9,31,.290,15,25,.600,96,37,77,.481,25,44,.568,12,33,.364,18,23,.783,104
747,2021-12-08,MIA,,MIL,W 113-104,240,40,77,.519,18,30,.600,22,47,.468,11,12,.917,113,36,85,.424,24,46,.522,12,39,.308,20,27,.741,104
748,2021-12-08,MIL,@,MIA,L 104-113,240,36,85,.424,24,46,.522,12,39,.308,20,27,.741,104,40,77,.519,18,30,.600,22,47,.468,11,12,.917,113
749,2021-12-08,MIN,,UTA,L 104-136,240,38,95,.400,21,48,.438,17,47,.362,11,17,.647,104,50,88,.568,25,34,.735,25,54,.463,11,15,.733,136
750,2021-12-08,UTA,@,MIN,W 136-104,240,50,88,.568,25,34,.735,25,54,.463,11,15,.733,136,38,95,.400,21,48,.438,17,47,.362,11,17,.647,104
751,2021-12-08,DEN,@,NOP,W 120-114 (OT),265,45,88,.511,36,56,.643,9,32,.281,21,27,.778,120,47,90,.522,36,60,.600,11,30,.367,9,12,.750,114
752,2021-12-08,NOP,,DEN,L 114-120 (OT),265,47,90,.522,36,60,.600,11,30,.367,9,12,.750,114,45,88,.511,36,56,.643,9,32,.281,21,27,.778,120
753,2021-12-08,ORL,@,SAC,L 130-142,240,48,97,.495,32,63,.508,16,34,.471,18,23,.783,130,53,97,.546,38,63,.603,15,34,.441,21,25,.840,142
754,2021-12-08,SAC,,ORL,W 142-130,240,53,97,.546,38,63,.603,15,34,.441,21,25,.840,142,48,97,.495,32,63,.508,16,34,.471,18,23,.783,130
755,2021-12-08,OKC,@,TOR,W 110-109,240,38,84,.452,21,44,.477,17,40,.425,17,20,.850,110,42,93,.452,27,52,.519,15,41,.366,10,15,.667,109
756,2021-12-08,TOR,,OKC,L 109-110,240,42,93,.452,27,52,.519,15,41,.366,10,15,.667,109,38,84,.452,21,44,.477,17,40,.425,17,20,.850,110
757,2021-12-09,LAL,@,MEM,L 95-108,240,36,78,.462,24,48,.500,12,30,.400,11,17,.647,95,41,94,.436,27,52,.519,14,42,.333,12,18,.667,108
758,2021-12-09,MEM,,LAL,W 108-95,240,41,94,.436,27,52,.519,14,42,.333,12,18,.667,108,36,78,.462,24,48,.500,12,30,.400,11,17,.647,95
759,2021-12-09,PHI,,UTA,L 96-118,240,38,88,.432,32,55,.582,6,33,.182,14,15,.933,96,43,91,.473,28,51,.549,15,40,.375,17,24,.708,118
760,2021-12-09,UTA,@,PHI,W 118-96,240,43,91,.473,28,51,.549,15,40,.375,17,24,.708,118,38,88,.432,32,55,.582,6,33,.182,14,15,.933,96
761,2021-12-09,DEN,@,SAS,L 111-123,240,42,94,.447,27,55,.491,15,39,.385,12,13,.923,111,46,88,.523,31,53,.585,15,35,.429,16,22,.727,123
762,2021-12-09,SAS,,DEN,W 123-111,240,46,88,.523,31,53,.585,15,35,.429,16,22,.727,123,42,94,.447,27,55,.491,15,39,.385,12,13,.923,111
763,2021-12-10,ATL,,BRK,L 105-113,240,37,94,.394,26,60,.433,11,34,.324,20,24,.833,105,46,93,.495,40,70,.571,6,23,.261,15,16,.938,113
764,2021-12-10,BRK,@,ATL,W 113-105,240,46,93,.495,40,70,.571,6,23,.261,15,16,.938,113,37,94,.394,26,60,.433,11,34,.324,20,24,.833,105
765,2021-12-10,CHO,,SAC,W 124-123,240,48,87,.552,34,52,.654,14,35,.400,14,20,.700,124,48,101,.475,34,60,.567,14,41,.341,13,17,.765,123
766,2021-12-10,SAC,@,CHO,L 123-124,240,48,101,.475,34,60,.567,14,41,.341,13,17,.765,123,48,87,.552,34,52,.654,14,35,.400,14,20,.700,124
767,2021-12-10,HOU,,MIL,L 114-123,240,42,89,.472,23,43,.535,19,46,.413,11,20,.550,114,42,83,.506,27,44,.614,15,39,.385,24,32,.750,123
768,2021-12-10,MIL,@,HOU,W 123-114,240,42,83,.506,27,44,.614,15,39,.385,24,32,.750,123,42,89,.472,23,43,.535,19,46,.413,11,20,.550,114
769,2021-12-10,DAL,@,IND,L 93-106,240,39,84,.464,35,55,.636,4,29,.138,11,12,.917,93,41,87,.471,28,51,.549,13,36,.361,11,12,.917,106
770,2021-12-10,IND,,DAL,W 106-93,240,41,87,.471,28,51,.549,13,36,.361,11,12,.917,106,39,84,.464,35,55,.636,4,29,.138,11,12,.917,93
771,2021-12-10,CLE,@,MIN,W 123-106,240,46,85,.541,33,52,.635,13,33,.394,18,22,.818,123,36,92,.391,25,53,.472,11,39,.282,23,28,.821,106
772,2021-12-10,MIN,,CLE,L 106-123,240,36,92,.391,25,53,.472,11,39,.282,23,28,.821,106,46,85,.541,33,52,.635,13,33,.394,18,22,.818,123
773,2021-12-10,DET,@,NOP,L 93-109,240,35,90,.389,23,53,.434,12,37,.324,11,12,.917,93,41,95,.432,28,58,.483,13,37,.351,14,16,.875,109
774,2021-12-10,NOP,,DET,W 109-93,240,41,95,.432,28,58,.483,13,37,.351,14,16,.875,109,35,90,.389,23,53,.434,12,37,.324,11,12,.917,93
775,2021-12-10,LAL,@,OKC,W 116-95,240,41,87,.471,22,45,.489,19,42,.452,15,20,.750,116,38,96,.396,28,52,.538,10,44,.227,9,14,.643,95
776,2021-12-10,OKC,,LAL,L 95-116,240,38,96,.396,28,52,.538,10,44,.227,9,14,.643,95,41,87,.471,22,45,.489,19,42,.452,15,20,.750,116
777,2021-12-10,BOS,@,PHO,L 90-111,240,35,93,.376,31,67,.463,4,26,.154,16,24,.667,90,43,96,.448,29,58,.500,14,38,.368,11,11,1.000,111
778,2021-12-10,PHO,,BOS,W 111-90,240,43,96,.448,29,58,.500,14,38,.368,11,11,1.000,111,35,93,.376,31,67,.463,4,26,.154,16,24,.667,90
779,2021-12-10,NYK,@,TOR,L 87-90,240,29,81,.358,20,47,.426,9,34,.265,20,24,.833,87,30,87,.345,18,52,.346,12,35,.343,18,23,.783,90
780,2021-12-10,TOR,,NYK,W 90-87,240,30,87,.345,18,52,.346,12,35,.343,18,23,.783,90,29,81,.358,20,47,.426,9,34,.265,20,24,.833,87
781,2021-12-11,CLE,,SAC,W 117-103,240,41,88,.466,29,57,.509,12,31,.387,23,28,.821,117,41,93,.441,34,65,.523,7,28,.250,14,22,.636,103
782,2021-12-11,SAC,@,CLE,L 103-117,240,41,93,.441,34,65,.523,7,28,.250,14,22,.636,103,41,88,.466,29,57,.509,12,31,.387,23,28,.821,117
783,2021-12-11,LAC,,ORL,W 106-104,240,42,92,.457,24,56,.429,18,36,.500,4,6,.667,106,35,80,.438,23,47,.489,12,33,.364,22,24,.917,104
784,2021-12-11,ORL,@,LAC,L 104-106,240,35,80,.438,23,47,.489,12,33,.364,22,24,.917,104,42,92,.457,24,56,.429,18,36,.500,4,6,.667,106
785,2021-12-11,HOU,@,MEM,L 106-113,240,38,77,.494,27,44,.614,11,33,.333,19,29,.655,106,40,80,.500,29,51,.569,11,29,.379,22,36,.611,113
786,2021-12-11,MEM,,HOU,W 113-106,240,40,80,.500,29,51,.569,11,29,.379,22,36,.611,113,38,77,.494,27,44,.614,11,33,.333,19,29,.655,106
787,2021-12-11,CHI,@,MIA,L 92-118,240,31,83,.373,14,43,.326,17,40,.425,13,20,.650,92,46,93,.495,27,50,.540,19,43,.442,7,9,.778,118
788,2021-12-11,MIA,,CHI,W 118-92,240,46,93,.495,27,50,.540,19,43,.442,7,9,.778,118,31,83,.373,14,43,.326,17,40,.425,13,20,.650,92
789,2021-12-11,GSW,@,PHI,L 93-102,240,34,85,.400,22,37,.595,12,48,.250,13,18,.722,93,35,76,.461,26,49,.531,9,27,.333,23,26,.885,102
790,2021-12-11,PHI,,GSW,W 102-93,240,35,76,.461,26,49,.531,9,27,.333,23,26,.885,102,34,85,.400,22,37,.595,12,48,.250,13,18,.722,93
791,2021-12-11,DEN,@,SAS,W 127-112,240,47,93,.505,27,50,.540,20,43,.465,13,14,.929,127,41,89,.461,31,62,.500,10,27,.370,20,29,.690,112
792,2021-12-11,SAS,,DEN,L 112-127,240,41,89,.461,31,62,.500,10,27,.370,20,29,.690,112,47,93,.505,27,50,.540,20,43,.465,13,14,.929,127
793,2021-12-11,UTA,@,WAS,W 123-98,240,48,93,.516,35,54,.648,13,39,.333,14,17,.824,123,41,89,.461,33,64,.516,8,25,.320,8,14,.571,98
794,2021-12-11,WAS,,UTA,L 98-123,240,41,89,.461,33,64,.516,8,25,.320,8,14,.571,98,48,93,.516,35,54,.648,13,39,.333,14,17,.824,123
795,2021-12-12,BRK,@,DET,W 116-104,240,41,87,.471,30,59,.508,11,28,.393,23,25,.920,116,39,92,.424,25,55,.455,14,37,.378,12,18,.667,104
796,2021-12-12,DET,,BRK,L 104-116,240,39,92,.424,25,55,.455,14,37,.378,12,18,.667,104,41,87,.471,30,59,.508,11,28,.393,23,25,.920,116
797,2021-12-12,LAL,,ORL,W 106-94,240,41,84,.488,28,56,.500,13,28,.464,11,17,.647,106,33,88,.375,20,50,.400,13,38,.342,15,19,.789,94
798,2021-12-12,ORL,@,LAL,L 94-106,240,33,88,.375,20,50,.400,13,38,.342,15,19,.789,94,41,84,.488,28,56,.500,13,28,.464,11,17,.647,106
799,2021-12-12,MIL,@,NYK,W 112-97,240,42,88,.477,28,47,.596,14,41,.341,14,17,.824,112,35,82,.427,18,33,.545,17,49,.347,10,13,.769,97
800,2021-12-12,NYK,,MIL,L 97-112,240,35,82,.427,18,33,.545,17,49,.347,10,13,.769,97,42,88,.477,28,47,.596,14,41,.341,14,17,.824,112
801,2021-12-12,DAL,@,OKC,W 103-84,240,38,90,.422,29,57,.509,9,33,.273,18,23,.783,103,30,80,.375,17,43,.395,13,37,.351,11,16,.688,84
802,2021-12-12,OKC,,DAL,L 84-103,240,30,80,.375,17,43,.395,13,37,.351,11,16,.688,84,38,90,.422,29,57,.509,9,33,.273,18,23,.783,103
803,2021-12-12,MIN,@,POR,W 116-111,240,38,85,.447,24,49,.490,14,36,.389,26,32,.813,116,37,81,.457,19,33,.576,18,48,.375,19,28,.679,111
804,2021-12-12,POR,,MIN,L 111-116,240,37,81,.457,19,33,.576,18,48,.375,19,28,.679,111,38,85,.447,24,49,.490,14,36,.389,26,32,.813,116
805,2021-12-12,NOP,@,SAS,L 97-112,240,40,94,.426,32,65,.492,8,29,.276,9,15,.600,97,45,91,.495,38,66,.576,7,25,.280,15,20,.750,112
806,2021-12-12,SAS,,NOP,W 112-97,240,45,91,.495,38,66,.576,7,25,.280,15,20,.750,112,40,94,.426,32,65,.492,8,29,.276,9,15,.600,97
807,2021-12-13,ATL,,HOU,L 126-132,240,42,85,.494,27,46,.587,15,39,.385,27,31,.871,126,46,96,.479,27,50,.540,19,46,.413,21,27,.778,132
808,2021-12-13,HOU,@,ATL,W 132-126,240,46,96,.479,27,50,.540,19,46,.413,21,27,.778,132,42,85,.494,27,46,.587,15,39,.385,27,31,.871,126
809,2021-12-13,BOS,,MIL,W 117-103,240,43,86,.500,23,39,.590,20,47,.426,11,13,.846,117,40,90,.444,29,54,.537,11,36,.306,12,15,.800,103
810,2021-12-13,MIL,@,BOS,L 103-117,240,40,90,.444,29,54,.537,11,36,.306,12,15,.800,103,43,86,.500,23,39,.590,20,47,.426,11,13,.846,117
811,2021-12-13,CLE,,MIA,W 105-94,240,36,81,.444,20,45,.444,16,36,.444,17,18,.944,105,38,85,.447,25,45,.556,13,40,.325,5,9,.556,94
812,2021-12-13,MIA,@,CLE,L 94-105,240,38,85,.447,25,45,.556,13,40,.325,5,9,.556,94,36,81,.444,20,45,.444,16,36,.444,17,18,.944,105
813,2021-12-13,CHO,@,DAL,L 96-120,240,34,86,.395,21,49,.429,13,37,.351,15,24,.625,96,43,83,.518,24,42,.571,19,41,.463,15,17,.882,120
814,2021-12-13,DAL,,CHO,W 120-96,240,43,83,.518,24,42,.571,19,41,.463,15,17,.882,120,34,86,.395,21,49,.429,13,37,.351,15,24,.625,96
815,2021-12-13,DEN,,WAS,W 113-107,240,37,79,.468,27,47,.574,10,32,.313,29,33,.879,113,41,90,.456,29,56,.518,12,34,.353,13,21,.619,107
816,2021-12-13,WAS,@,DEN,L 107-113,240,41,90,.456,29,56,.518,12,34,.353,13,21,.619,107,37,79,.468,27,47,.574,10,32,.313,29,33,.879,113
817,2021-12-13,GSW,@,IND,W 102-100,240,42,84,.500,34,54,.630,8,30,.267,10,14,.714,102,35,87,.402,28,57,.491,7,30,.233,23,31,.742,100
818,2021-12-13,IND,,GSW,L 100-102,240,35,87,.402,28,57,.491,7,30,.233,23,31,.742,100,42,84,.500,34,54,.630,8,30,.267,10,14,.714,102
819,2021-12-13,LAC,,PHO,W 111-95,240,43,78,.551,34,57,.596,9,21,.429,16,23,.696,111,36,96,.375,29,67,.433,7,29,.241,16,19,.842,95
820,2021-12-13,PHO,@,LAC,L 95-111,240,36,96,.375,29,67,.433,7,29,.241,16,19,.842,95,43,78,.551,34,57,.596,9,21,.429,16,23,.696,111
821,2021-12-13,MEM,,PHI,W 126-91,240,47,89,.528,33,55,.600,14,34,.412,18,23,.783,126,37,83,.446,33,61,.541,4,22,.182,13,19,.684,91
822,2021-12-13,PHI,@,MEM,L 91-126,240,37,83,.446,33,61,.541,4,22,.182,13,19,.684,91,47,89,.528,33,55,.600,14,34,.412,18,23,.783,126
823,2021-12-13,SAC,@,TOR,L 101-124,240,38,94,.404,27,60,.450,11,34,.324,14,21,.667,101,53,98,.541,42,67,.627,11,31,.355,7,10,.700,124
824,2021-12-13,TOR,,SAC,W 124-101,240,53,98,.541,42,67,.627,11,31,.355,7,10,.700,124,38,94,.404,27,60,.450,11,34,.324,14,21,.667,101
825,2021-12-14,BRK,,TOR,W 131-129 (OT),265,50,103,.485,36,64,.563,14,39,.359,17,23,.739,131,48,105,.457,30,53,.566,18,52,.346,15,19,.789,129
826,2021-12-14,TOR,@,BRK,L 129-131 (OT),265,48,105,.457,30,53,.566,18,52,.346,15,19,.789,129,50,103,.485,36,64,.563,14,39,.359,17,23,.739,131
827,2021-12-14,GSW,@,NYK,W 105-96,240,35,77,.455,20,37,.541,15,40,.375,20,27,.741,105,30,83,.361,14,41,.341,16,42,.381,20,22,.909,96
828,2021-12-14,NYK,,GSW,L 96-105,240,30,83,.361,14,41,.341,16,42,.381,20,22,.909,96,35,77,.455,20,37,.541,15,40,.375,20,27,.741,105
829,2021-12-14,PHO,@,POR,W 111-107 (OT),265,44,93,.473,33,62,.532,11,31,.355,12,15,.800,111,40,96,.417,27,55,.491,13,41,.317,14,22,.636,107
830,2021-12-14,POR,,PHO,L 107-111 (OT),265,40,96,.417,27,55,.491,13,41,.317,14,22,.636,107,44,93,.473,33,62,.532,11,31,.355,12,15,.800,111
831,2021-12-15,CLE,,HOU,W 124-89,240,45,80,.563,27,40,.675,18,40,.450,16,24,.667,124,30,78,.385,25,49,.510,5,29,.172,24,35,.686,89
832,2021-12-15,HOU,@,CLE,L 89-124,240,30,78,.385,25,49,.510,5,29,.172,24,35,.686,89,45,80,.563,27,40,.675,18,40,.450,16,24,.667,124
833,2021-12-15,DAL,,LAL,L 104-107 (OT),265,39,98,.398,27,54,.500,12,44,.273,14,17,.824,104,39,90,.433,24,51,.471,15,39,.385,14,18,.778,107
834,2021-12-15,LAL,@,DAL,W 107-104 (OT),265,39,90,.433,24,51,.471,15,39,.385,14,18,.778,107,39,98,.398,27,54,.500,12,44,.273,14,17,.824,104
835,2021-12-15,DEN,,MIN,L 107-124,240,38,84,.452,24,45,.533,14,39,.359,17,23,.739,107,45,88,.511,22,40,.550,23,48,.479,11,16,.688,124
836,2021-12-15,MIN,@,DEN,W 124-107,240,45,88,.511,22,40,.550,23,48,.479,11,16,.688,124,38,84,.452,24,45,.533,14,39,.359,17,23,.739,107
837,2021-12-15,IND,@,MIL,L 99-114,240,39,83,.470,28,45,.622,11,38,.289,10,11,.909,99,44,90,.489,30,61,.492,14,29,.483,12,15,.800,114
838,2021-12-15,MIL,,IND,W 114-99,240,44,90,.489,30,61,.492,14,29,.483,12,15,.800,114,39,83,.470,28,45,.622,11,38,.289,10,11,.909,99
839,2021-12-15,NOP,@,OKC,W 113-110,240,39,80,.488,28,52,.538,11,28,.393,24,36,.667,113,39,93,.419,26,58,.448,13,35,.371,19,19,1.000,110
840,2021-12-15,OKC,,NOP,L 110-113,240,39,93,.419,26,58,.448,13,35,.371,19,19,1.000,110,39,80,.488,28,52,.538,11,28,.393,24,36,.667,113
841,2021-12-15,ATL,@,ORL,W 111-99,240,42,85,.494,31,54,.574,11,31,.355,16,16,1.000,111,35,90,.389,25,55,.455,10,35,.286,19,21,.905,99
842,2021-12-15,ORL,,ATL,L 99-111,240,35,90,.389,25,55,.455,10,35,.286,19,21,.905,99,42,85,.494,31,54,.574,11,31,.355,16,16,1.000,111
843,2021-12-15,MIA,@,PHI,W 101-96,240,35,78,.449,17,34,.500,18,44,.409,13,17,.765,101,35,79,.443,23,42,.548,12,37,.324,14,17,.824,96
844,2021-12-15,PHI,,MIA,L 96-101,240,35,79,.443,23,42,.548,12,37,.324,14,17,.824,96,35,78,.449,17,34,.500,18,44,.409,13,17,.765,101
845,2021-12-15,MEM,@,POR,W 113-103,240,39,82,.476,28,50,.560,11,32,.344,24,30,.800,113,31,82,.378,16,44,.364,15,38,.395,26,28,.929,103
846,2021-12-15,POR,,MEM,L 103-113,240,31,82,.378,16,44,.364,15,38,.395,26,28,.929,103,39,82,.476,28,50,.560,11,32,.344,24,30,.800,113
847,2021-12-15,SAC,,WAS,W 119-105,240,45,82,.549,37,56,.661,8,26,.308,21,29,.724,119,42,89,.472,37,65,.569,5,24,.208,16,21,.762,105
848,2021-12-15,WAS,@,SAC,L 105-119,240,42,89,.472,37,65,.569,5,24,.208,16,21,.762,105,45,82,.549,37,56,.661,8,26,.308,21,29,.724,119
849,2021-12-15,CHO,@,SAS,W 131-115,240,51,86,.593,33,52,.635,18,34,.529,11,16,.688,131,39,90,.433,27,53,.509,12,37,.324,25,25,1.000,115
850,2021-12-15,SAS,,CHO,L 115-131,240,39,90,.433,27,53,.509,12,37,.324,25,25,1.000,115,51,86,.593,33,52,.635,18,34,.529,11,16,.688,131
851,2021-12-15,LAC,@,UTA,L 103-124,240,40,85,.471,30,55,.545,10,30,.333,13,20,.650,103,47,89,.528,32,52,.615,15,37,.405,15,20,.750,124
852,2021-12-15,UTA,,LAC,W 124-103,240,47,89,.528,32,52,.615,15,37,.405,15,20,.750,124,40,85,.471,30,55,.545,10,30,.333,13,20,.650,103
853,2021-12-16,BRK,,PHI,W 114-105,240,44,89,.494,33,66,.500,11,23,.478,15,16,.938,114,39,89,.438,29,55,.527,10,34,.294,17,20,.850,105
854,2021-12-16,PHI,@,BRK,L 105-114,240,39,89,.438,29,55,.527,10,34,.294,17,20,.850,105,44,89,.494,33,66,.500,11,23,.478,15,16,.938,114
855,2021-12-16,HOU,,NYK,L 103-116,240,34,68,.500,23,36,.639,11,32,.344,24,30,.800,103,39,83,.470,22,47,.468,17,36,.472,21,25,.840,116
856,2021-12-16,NYK,@,HOU,W 116-103,240,39,83,.470,22,47,.468,17,36,.472,21,25,.840,116,34,68,.500,23,36,.639,11,32,.344,24,30,.800,103
857,2021-12-16,DET,@,IND,L 113-122,240,40,81,.494,33,56,.589,7,25,.280,26,30,.867,113,45,91,.495,38,59,.644,7,32,.219,25,28,.893,122
858,2021-12-16,IND,,DET,W 122-113,240,45,91,.495,38,59,.644,7,32,.219,25,28,.893,122,40,81,.494,33,56,.589,7,25,.280,26,30,.867,113
859,2021-12-16,PHO,,WAS,W 118-98,240,42,79,.532,33,50,.660,9,29,.310,25,26,.962,118,40,82,.488,34,61,.557,6,21,.286,12,19,.632,98
860,2021-12-16,WAS,@,PHO,L 98-118,240,40,82,.488,34,61,.557,6,21,.286,12,19,.632,98,42,79,.532,33,50,.660,9,29,.310,25,26,.962,118
861,2021-12-17,ATL,,DEN,L 115-133,240,41,88,.466,34,64,.531,7,24,.292,26,34,.765,115,50,86,.581,33,48,.688,17,38,.447,16,18,.889,133
862,2021-12-17,DEN,@,ATL,W 133-115,240,50,86,.581,33,48,.688,17,38,.447,16,18,.889,133,41,88,.466,34,64,.531,7,24,.292,26,34,.765,115
863,2021-12-17,BOS,,GSW,L 107-111,240,36,82,.439,21,41,.512,15,41,.366,20,29,.690,107,39,90,.433,23,44,.523,16,46,.348,17,21,.810,111
864,2021-12-17,GSW,@,BOS,W 111-107,240,39,90,.433,23,44,.523,16,46,.348,17,21,.810,111,36,82,.439,21,41,.512,15,41,.366,20,29,.690,107
865,2021-12-17,LAL,@,MIN,L 92-110,240,30,78,.385,18,35,.514,12,43,.279,20,29,.690,92,41,98,.418,29,54,.537,12,44,.273,16,24,.667,110
866,2021-12-17,MIN,,LAL,W 110-92,240,41,98,.418,29,54,.537,12,44,.273,16,24,.667,110,30,78,.385,18,35,.514,12,43,.279,20,29,.690,92
867,2021-12-17,MIL,@,NOP,L 112-116 (OT),265,45,104,.433,31,57,.544,14,47,.298,8,10,.800,112,42,89,.472,29,52,.558,13,37,.351,19,30,.633,116
868,2021-12-17,NOP,,MIL,W 116-112 (OT),265,42,89,.472,29,52,.558,13,37,.351,19,30,.633,116,45,104,.433,31,57,.544,14,47,.298,8,10,.800,112
869,2021-12-17,MIA,@,ORL,W 115-105,240,41,82,.500,22,47,.468,19,35,.543,14,19,.737,115,43,89,.483,32,57,.561,11,32,.344,8,10,.800,105
870,2021-12-17,ORL,,MIA,L 105-115,240,43,89,.483,32,57,.561,11,32,.344,8,10,.800,105,41,82,.500,22,47,.468,19,35,.543,14,19,.737,115
871,2021-12-17,CHO,@,POR,L 116-125,240,44,92,.478,31,55,.564,13,37,.351,15,18,.833,116,44,85,.518,23,38,.605,21,47,.447,16,18,.889,125
872,2021-12-17,POR,,CHO,W 125-116,240,44,85,.518,23,38,.605,21,47,.447,16,18,.889,125,44,92,.478,31,55,.564,13,37,.351,15,18,.833,116
873,2021-12-17,MEM,@,SAC,W 124-105,240,45,97,.464,32,73,.438,13,24,.542,21,27,.778,124,36,88,.409,23,53,.434,13,35,.371,20,26,.769,105
874,2021-12-17,SAC,,MEM,L 105-124,240,36,88,.409,23,53,.434,13,35,.371,20,26,.769,105,45,97,.464,32,73,.438,13,24,.542,21,27,.778,124
875,2021-12-17,SAS,@,UTA,W 128-126,240,50,100,.500,35,59,.593,15,41,.366,13,18,.722,128,46,93,.495,33,56,.589,13,37,.351,21,26,.808,126
876,2021-12-17,UTA,,SAS,L 126-128,240,46,93,.495,33,56,.589,13,37,.351,21,26,.808,126,50,100,.500,35,59,.593,15,41,.366,13,18,.722,128
877,2021-12-18,BOS,,NYK,W 114-107,240,42,89,.472,25,44,.568,17,45,.378,13,17,.765,114,35,80,.438,22,44,.500,13,36,.361,24,30,.800,107
878,2021-12-18,NYK,@,BOS,L 107-114,240,35,80,.438,22,44,.500,13,36,.361,24,30,.800,107,42,89,.472,25,44,.568,17,45,.378,13,17,.765,114
879,2021-12-18,BRK,,ORL,L 93-100,240,39,102,.382,30,56,.536,9,46,.196,6,8,.750,93,39,94,.415,29,63,.460,10,31,.323,12,13,.923,100
880,2021-12-18,ORL,@,BRK,W 100-93,240,39,94,.415,29,63,.460,10,31,.323,12,13,.923,100,39,102,.382,30,56,.536,9,46,.196,6,8,.750,93
881,2021-12-18,DET,,HOU,L 107-116,240,43,93,.462,33,57,.579,10,36,.278,11,16,.688,107,46,93,.495,32,55,.582,14,38,.368,10,17,.588,116
882,2021-12-18,HOU,@,DET,W 116-107,240,46,93,.495,32,55,.582,14,38,.368,10,17,.588,116,43,93,.462,33,57,.579,10,36,.278,11,16,.688,107
883,2021-12-18,CLE,@,MIL,W 119-90,240,45,90,.500,29,45,.644,16,45,.356,13,14,.929,119,35,89,.393,23,51,.451,12,38,.316,8,11,.727,90
884,2021-12-18,MIL,,CLE,L 90-119,240,35,89,.393,23,51,.451,12,38,.316,8,11,.727,90,45,90,.500,29,45,.644,16,45,.356,13,14,.929,119
885,2021-12-18,LAC,@,OKC,L 103-104,240,37,83,.446,21,44,.477,16,39,.410,13,19,.684,103,43,92,.467,31,61,.508,12,31,.387,6,10,.600,104
886,2021-12-18,OKC,,LAC,W 104-103,240,43,92,.467,31,61,.508,12,31,.387,6,10,.600,104,37,83,.446,21,44,.477,16,39,.410,13,19,.684,103
887,2021-12-18,GSW,@,TOR,L 100-119,240,37,79,.468,26,43,.605,11,36,.306,15,21,.714,100,45,90,.500,31,52,.596,14,38,.368,15,23,.652,119
888,2021-12-18,TOR,,GSW,W 119-100,240,45,90,.500,31,52,.596,14,38,.368,15,23,.652,119,37,79,.468,26,43,.605,11,36,.306,15,21,.714,100
889,2021-12-18,UTA,,WAS,L 103-109,240,35,81,.432,21,37,.568,14,44,.318,19,30,.633,103,42,94,.447,33,63,.524,9,31,.290,16,20,.800,109
890,2021-12-18,WAS,@,UTA,W 109-103,240,42,94,.447,33,63,.524,9,31,.290,16,20,.800,109,35,81,.432,21,37,.568,14,44,.318,19,30,.633,103
891,2021-12-19,CHI,,LAL,W 115-110,240,40,93,.430,30,63,.476,10,30,.333,25,31,.806,115,42,82,.512,30,48,.625,12,34,.353,14,22,.636,110
892,2021-12-19,LAL,@,CHI,L 110-115,240,42,82,.512,30,48,.625,12,34,.353,14,22,.636,110,40,93,.430,30,63,.476,10,30,.333,25,31,.806,115
893,2021-12-19,DET,,MIA,W 100-90,240,35,75,.467,27,43,.628,8,32,.250,22,30,.733,100,28,74,.378,15,31,.484,13,43,.302,21,33,.636,90
894,2021-12-19,MIA,@,DET,L 90-100,240,28,74,.378,15,31,.484,13,43,.302,21,33,.636,90,35,75,.467,27,43,.628,8,32,.250,22,30,.733,100
895,2021-12-19,MEM,,POR,L 100-105,240,35,91,.385,26,57,.456,9,34,.265,21,25,.840,100,35,74,.473,24,42,.571,11,32,.344,24,28,.857,105
896,2021-12-19,POR,@,MEM,W 105-100,240,35,74,.473,24,42,.571,11,32,.344,24,28,.857,105,35,91,.385,26,57,.456,9,34,.265,21,25,.840,100
897,2021-12-19,DAL,@,MIN,L 105-111,240,36,82,.439,24,41,.585,12,41,.293,21,22,.955,105,36,77,.468,21,43,.488,15,34,.441,24,31,.774,111
898,2021-12-19,MIN,,DAL,W 111-105,240,36,77,.468,21,43,.488,15,34,.441,24,31,.774,111,36,82,.439,24,41,.585,12,41,.293,21,22,.955,105
899,2021-12-19,CHO,@,PHO,L 106-137,240,36,100,.360,26,55,.473,10,45,.222,24,28,.857,106,54,95,.568,34,54,.630,20,41,.488,9,13,.692,137
900,2021-12-19,PHO,,CHO,W 137-106,240,54,95,.568,34,54,.630,20,41,.488,9,13,.692,137,36,100,.360,26,55,.473,10,45,.222,24,28,.857,106
901,2021-12-19,SAC,,SAS,W 121-114,240,46,91,.505,32,66,.485,14,25,.560,15,18,.833,121,45,91,.495,33,66,.500,12,25,.480,12,13,.923,114
902,2021-12-19,SAS,@,SAC,L 114-121,240,45,91,.495,33,66,.500,12,25,.480,12,13,.923,114,46,91,.505,32,66,.485,14,25,.560,15,18,.833,121
903,2021-12-20,BOS,,PHI,L 103-108,240,38,82,.463,31,55,.564,7,27,.259,20,25,.800,103,36,72,.500,26,47,.553,10,25,.400,26,31,.839,108
904,2021-12-20,PHI,@,BOS,W 108-103,240,36,72,.500,26,47,.553,10,25,.400,26,31,.839,108,38,82,.463,31,55,.564,7,27,.259,20,25,.800,103
905,2021-12-20,CHI,,HOU,W 133-118,240,47,88,.534,31,53,.585,16,35,.457,23,24,.958,133,44,78,.564,32,45,.711,12,33,.364,18,24,.750,118
906,2021-12-20,HOU,@,CHI,L 118-133,240,44,78,.564,32,45,.711,12,33,.364,18,24,.750,118,47,88,.534,31,53,.585,16,35,.457,23,24,.958,133
907,2021-12-20,GSW,,SAC,W 113-98,240,46,88,.523,31,51,.608,15,37,.405,6,9,.667,113,37,83,.446,24,51,.471,13,32,.406,11,16,.688,98
908,2021-12-20,SAC,@,GSW,L 98-113,240,37,83,.446,24,51,.471,13,32,.406,11,16,.688,98,46,88,.523,31,51,.608,15,37,.405,6,9,.667,113
909,2021-12-20,LAC,,SAS,L 92-116,240,34,87,.391,25,55,.455,9,32,.281,15,20,.750,92,50,114,.439,38,77,.494,12,37,.324,4,6,.667,116
910,2021-12-20,SAS,@,LAC,W 116-92,240,50,114,.439,38,77,.494,12,37,.324,4,6,.667,116,34,87,.391,25,55,.455,9,32,.281,15,20,.750,92
911,2021-12-20,MEM,,OKC,L 99-102,240,39,101,.386,28,69,.406,11,32,.344,10,13,.769,99,36,84,.429,25,46,.543,11,38,.289,19,28,.679,102
912,2021-12-20,OKC,@,MEM,W 102-99,240,36,84,.429,25,46,.543,11,38,.289,19,28,.679,102,39,101,.386,28,69,.406,11,32,.344,10,13,.769,99
913,2021-12-20,CHO,@,UTA,L 102-112,240,39,101,.386,24,58,.414,15,43,.349,9,9,1.000,102,34,96,.354,18,43,.419,16,53,.302,28,37,.757,112
914,2021-12-20,UTA,,CHO,W 112-102,240,34,96,.354,18,43,.419,16,53,.302,28,37,.757,112,39,101,.386,24,58,.414,15,43,.349,9,9,1.000,102
915,2021-12-21,DAL,,MIN,W 114-102,240,42,86,.488,31,52,.596,11,34,.324,19,23,.826,114,36,79,.456,23,39,.590,13,40,.325,17,20,.850,102
916,2021-12-21,MIN,@,DAL,L 102-114,240,36,79,.456,23,39,.590,13,40,.325,17,20,.850,102,42,86,.488,31,52,.596,11,34,.324,19,23,.826,114
917,2021-12-21,LAL,,PHO,L 90-108,240,34,87,.391,27,52,.519,7,35,.200,15,23,.652,90,41,93,.441,29,52,.558,12,41,.293,14,15,.933,108
918,2021-12-21,PHO,@,LAL,W 108-90,240,41,93,.441,29,52,.558,12,41,.293,14,15,.933,108,34,87,.391,27,52,.519,7,35,.200,15,23,.652,90
919,2021-12-21,IND,@,MIA,L 96-125,240,31,87,.356,20,56,.357,11,31,.355,23,28,.821,96,47,95,.495,25,46,.543,22,49,.449,9,11,.818,125
920,2021-12-21,MIA,,IND,W 125-96,240,47,95,.495,25,46,.543,22,49,.449,9,11,.818,125,31,87,.356,20,56,.357,11,31,.355,23,28,.821,96
921,2021-12-21,NOP,,POR,W 111-97,240,42,80,.525,30,47,.638,12,33,.364,15,18,.833,111,35,78,.449,22,44,.500,13,34,.382,14,19,.737,97
922,2021-12-21,POR,@,NOP,L 97-111,240,35,78,.449,22,44,.500,13,34,.382,14,19,.737,97,42,80,.525,30,47,.638,12,33,.364,15,18,.833,111
923,2021-12-21,DET,@,NYK,L 91-105,240,34,94,.362,26,61,.426,8,33,.242,15,19,.789,91,40,90,.444,29,57,.509,11,33,.333,14,19,.737,105
924,2021-12-21,NYK,,DET,W 105-91,240,40,90,.444,29,57,.509,11,33,.333,14,19,.737,105,34,94,.362,26,61,.426,8,33,.242,15,19,.789,91
925,2021-12-22,ATL,,ORL,L 98-104,240,32,80,.400,20,49,.408,12,31,.387,22,29,.759,98,38,85,.447,27,48,.563,11,37,.297,17,23,.739,104
926,2021-12-22,ORL,@,ATL,W 104-98,240,38,85,.447,27,48,.563,11,37,.297,17,23,.739,104,32,80,.400,20,49,.408,12,31,.387,22,29,.759,98
927,2021-12-22,BOS,,CLE,W 111-101,240,43,92,.467,32,62,.516,11,30,.367,14,18,.778,111,36,92,.391,27,54,.500,9,38,.237,20,24,.833,101
928,2021-12-22,CLE,@,BOS,L 101-111,240,36,92,.391,27,54,.500,9,38,.237,20,24,.833,101,43,92,.467,32,62,.516,11,30,.367,14,18,.778,111
929,2021-12-22,HOU,@,MIL,L 106-126,240,36,86,.419,23,41,.561,13,45,.289,21,31,.677,106,45,103,.437,28,57,.491,17,46,.370,19,21,.905,126
930,2021-12-22,MIL,,HOU,W 126-106,240,45,103,.437,28,57,.491,17,46,.370,19,21,.905,126,36,86,.419,23,41,.561,13,45,.289,21,31,.677,106
931,2021-12-22,DEN,@,OKC,L 94-108,240,33,84,.393,20,40,.500,13,44,.295,15,26,.577,94,42,94,.447,34,60,.567,8,34,.235,16,19,.842,108
932,2021-12-22,OKC,,DEN,W 108-94,240,42,94,.447,34,60,.567,8,34,.235,16,19,.842,108,33,84,.393,20,40,.500,13,44,.295,15,26,.577,94
933,2021-12-22,LAC,@,SAC,W 105-89,240,42,82,.512,35,58,.603,7,24,.292,14,16,.875,105,34,85,.400,22,47,.468,12,38,.316,9,12,.750,89
934,2021-12-22,SAC,,LAC,L 89-105,240,34,85,.400,22,47,.468,12,38,.316,9,12,.750,89,42,82,.512,35,58,.603,7,24,.292,14,16,.875,105
935,2021-12-23,DAL,,MIL,L 95-102,240,35,86,.407,23,41,.561,12,45,.267,13,17,.765,95,37,82,.451,27,46,.587,10,36,.278,18,22,.818,102
936,2021-12-23,MIL,@,DAL,W 102-95,240,37,82,.451,27,46,.587,10,36,.278,18,22,.818,102,35,86,.407,23,41,.561,12,45,.267,13,17,.765,95
937,2021-12-23,CHO,@,DEN,W 115-107,240,39,94,.415,23,47,.489,16,47,.340,21,24,.875,115,40,96,.417,26,56,.464,14,40,.350,13,17,.765,107
938,2021-12-23,DEN,,CHO,L 107-115,240,40,96,.417,26,56,.464,14,40,.350,13,17,.765,107,39,94,.415,23,47,.489,16,47,.340,21,24,.875,115
939,2021-12-23,GSW,,MEM,W 113-104,240,40,82,.488,21,42,.500,19,40,.475,14,18,.778,113,38,90,.422,30,64,.469,8,26,.308,20,24,.833,104
940,2021-12-23,MEM,@,GSW,L 104-113,240,38,90,.422,30,64,.469,8,26,.308,20,24,.833,104,40,82,.488,21,42,.500,19,40,.475,14,18,.778,113
941,2021-12-23,HOU,@,IND,L 106-118,240,35,80,.438,20,43,.465,15,37,.405,21,26,.808,106,46,88,.523,33,50,.660,13,38,.342,13,19,.684,118
942,2021-12-23,IND,,HOU,W 118-106,240,46,88,.523,33,50,.660,13,38,.342,13,19,.684,118,35,80,.438,20,43,.465,15,37,.405,21,26,.808,106
943,2021-12-23,LAL,,SAS,L 110-138,240,44,94,.468,39,67,.582,5,27,.185,17,30,.567,110,46,95,.484,28,56,.500,18,39,.462,28,33,.848,138
944,2021-12-23,SAS,@,LAL,W 138-110,240,46,95,.484,28,56,.500,18,39,.462,28,33,.848,138,44,94,.468,39,67,.582,5,27,.185,17,30,.567,110
945,2021-12-23,DET,@,MIA,L 112-115,240,36,80,.450,18,40,.450,18,40,.450,22,25,.880,112,43,88,.489,31,56,.554,12,32,.375,17,19,.895,115
946,2021-12-23,MIA,,DET,W 115-112,240,43,88,.489,31,56,.554,12,32,.375,17,19,.895,115,36,80,.450,18,40,.450,18,40,.450,22,25,.880,112
947,2021-12-23,NYK,,WAS,L 117-124,240,42,93,.452,29,51,.569,13,42,.310,20,23,.870,117,42,75,.560,26,38,.684,16,37,.432,24,32,.750,124
948,2021-12-23,WAS,@,NYK,W 124-117,240,42,75,.560,26,38,.684,16,37,.432,24,32,.750,124,42,93,.452,29,51,.569,13,42,.310,20,23,.870,117
949,2021-12-23,NOP,@,ORL,W 110-104,240,37,86,.430,24,56,.429,13,30,.433,23,26,.885,110,38,88,.432,29,56,.518,9,32,.281,19,21,.905,104
950,2021-12-23,ORL,,NOP,L 104-110,240,38,88,.432,29,56,.518,9,32,.281,19,21,.905,104,37,86,.430,24,56,.429,13,30,.433,23,26,.885,110
951,2021-12-23,ATL,@,PHI,W 98-96,240,37,82,.451,30,58,.517,7,24,.292,17,19,.895,98,33,80,.413,27,53,.509,6,27,.222,24,26,.923,96
952,2021-12-23,PHI,,ATL,L 96-98,240,33,80,.413,27,53,.509,6,27,.222,24,26,.923,96,37,82,.451,30,58,.517,7,24,.292,17,19,.895,98
953,2021-12-23,OKC,@,PHO,L 101-113,240,37,96,.385,26,55,.473,11,41,.268,16,21,.762,101,45,93,.484,30,54,.556,15,39,.385,8,13,.615,113
954,2021-12-23,PHO,,OKC,W 113-101,240,45,93,.484,30,54,.556,15,39,.385,8,13,.615,113,37,96,.385,26,55,.473,11,41,.268,16,21,.762,101
955,2021-12-23,MIN,@,UTA,L 116-128,240,45,101,.446,28,56,.500,17,45,.378,9,12,.750,116,48,90,.533,32,51,.627,16,39,.410,16,22,.727,128
956,2021-12-23,UTA,,MIN,W 128-116,240,48,90,.533,32,51,.627,16,39,.410,16,22,.727,128,45,101,.446,28,56,.500,17,45,.378,9,12,.750,116
957,2021-12-25,BRK,@,LAL,W 122-115,240,43,89,.483,29,57,.509,14,32,.438,22,27,.815,122,40,96,.417,30,61,.492,10,35,.286,25,28,.893,115
958,2021-12-25,LAL,,BRK,L 115-122,240,40,96,.417,30,61,.492,10,35,.286,25,28,.893,115,43,89,.483,29,57,.509,14,32,.438,22,27,.815,122
959,2021-12-25,BOS,@,MIL,L 113-117,240,38,89,.427,21,44,.477,17,45,.378,20,24,.833,113,43,91,.473,31,58,.534,12,33,.364,19,27,.704,117
960,2021-12-25,MIL,,BOS,W 117-113,240,43,91,.473,31,58,.534,12,33,.364,19,27,.704,117,38,89,.427,21,44,.477,17,45,.378,20,24,.833,113
961,2021-12-25,ATL,@,NYK,L 87-101,240,33,87,.379,20,49,.408,13,38,.342,8,14,.571,87,38,85,.447,18,35,.514,20,50,.400,5,12,.417,101
962,2021-12-25,NYK,,ATL,W 101-87,240,38,85,.447,18,35,.514,20,50,.400,5,12,.417,101,33,87,.379,20,49,.408,13,38,.342,8,14,.571,87
963,2021-12-25,GSW,@,PHO,W 116-107,240,42,85,.494,28,48,.583,14,37,.378,18,21,.857,116,40,83,.482,29,53,.547,11,30,.367,16,16,1.000,107
964,2021-12-25,PHO,,GSW,L 107-116,240,40,83,.482,29,53,.547,11,30,.367,16,16,1.000,107,42,85,.494,28,48,.583,14,37,.378,18,21,.857,116
965,2021-12-25,DAL,@,UTA,L 116-120,240,38,89,.427,28,59,.475,10,30,.333,30,35,.857,116,40,90,.444,28,54,.519,12,36,.333,28,37,.757,120
966,2021-12-25,UTA,,DAL,W 120-116,240,40,90,.444,28,54,.519,12,36,.333,28,37,.757,120,38,89,.427,28,59,.475,10,30,.333,30,35,.857,116
967,2021-12-26,CHI,,IND,W 113-105,240,43,76,.566,32,53,.604,11,23,.478,16,22,.727,113,41,94,.436,33,64,.516,8,30,.267,15,21,.714,105
968,2021-12-26,IND,@,CHI,L 105-113,240,41,94,.436,33,64,.516,8,30,.267,15,21,.714,105,43,76,.566,32,53,.604,11,23,.478,16,22,.727,113
969,2021-12-26,CLE,,TOR,W 144-99,240,56,106,.528,34,54,.630,22,52,.423,10,12,.833,144,37,89,.416,28,53,.528,9,36,.250,16,23,.696,99
970,2021-12-26,TOR,@,CLE,L 99-144,240,37,89,.416,28,53,.528,9,36,.250,16,23,.696,99,56,106,.528,34,54,.630,22,52,.423,10,12,.833,144
971,2021-12-26,DEN,@,LAC,W 103-100,240,39,95,.411,24,54,.444,15,41,.366,10,11,.909,103,40,86,.465,32,60,.533,8,26,.308,12,18,.667,100
972,2021-12-26,LAC,,DEN,L 100-103,240,40,86,.465,32,60,.533,8,26,.308,12,18,.667,100,39,95,.411,24,54,.444,15,41,.366,10,11,.909,103
973,2021-12-26,MIA,,ORL,W 93-83,240,36,89,.404,26,55,.473,10,34,.294,11,18,.611,93,31,72,.431,21,40,.525,10,32,.313,11,17,.647,83
974,2021-12-26,ORL,@,MIA,L 83-93,240,31,72,.431,21,40,.525,10,32,.313,11,17,.647,83,36,89,.404,26,55,.473,10,34,.294,11,18,.611,93
975,2021-12-26,NOP,@,OKC,L 112-117,240,39,94,.415,29,53,.547,10,41,.244,24,28,.857,112,41,86,.477,28,50,.560,13,36,.361,22,31,.710,117
976,2021-12-26,OKC,,NOP,W 117-112,240,41,86,.477,28,50,.560,13,36,.361,22,31,.710,117,39,94,.415,29,53,.547,10,41,.244,24,28,.857,112
977,2021-12-26,MEM,@,SAC,W 127-102,240,47,100,.470,38,70,.543,9,30,.300,24,30,.800,127,34,81,.420,24,52,.462,10,29,.345,24,27,.889,102
978,2021-12-26,SAC,,MEM,L 102-127,240,34,81,.420,24,52,.462,10,29,.345,24,27,.889,102,47,100,.470,38,70,.543,9,30,.300,24,30,.800,127
979,2021-12-26,DET,@,SAS,L 109-144,240,38,98,.388,30,66,.455,8,32,.250,25,34,.735,109,51,91,.560,38,64,.594,13,27,.481,29,37,.784,144
980,2021-12-26,SAS,,DET,W 144-109,240,51,91,.560,38,64,.594,13,27,.481,29,37,.784,144,38,98,.388,30,66,.455,8,32,.250,25,34,.735,109
981,2021-12-26,PHI,@,WAS,W 117-96,240,43,86,.500,31,55,.564,12,31,.387,19,22,.864,117,35,90,.389,27,57,.474,8,33,.242,18,28,.643,96
982,2021-12-26,WAS,,PHI,L 96-117,240,35,90,.389,27,57,.474,8,33,.242,18,28,.643,96,43,86,.500,31,55,.564,12,31,.387,19,22,.864,117
983,2021-12-27,ATL,,CHI,L 118-130,240,40,89,.449,25,55,.455,15,34,.441,23,26,.885,118,51,94,.543,33,57,.579,18,37,.486,10,14,.714,130
984,2021-12-27,CHI,@,ATL,W 130-118,240,51,94,.543,33,57,.579,18,37,.486,10,14,.714,130,40,89,.449,25,55,.455,15,34,.441,23,26,.885,118
985,2021-12-27,CHO,,HOU,W 123-99,240,47,88,.534,29,47,.617,18,41,.439,11,14,.786,123,36,87,.414,21,41,.512,15,46,.326,12,18,.667,99
986,2021-12-27,HOU,@,CHO,L 99-123,240,36,87,.414,21,41,.512,15,46,.326,12,18,.667,99,47,88,.534,29,47,.617,18,41,.439,11,14,.786,123
987,2021-12-27,BRK,@,LAC,W 124-108,240,50,88,.568,37,54,.685,13,34,.382,11,16,.688,124,37,97,.381,23,60,.383,14,37,.378,20,27,.741,108
988,2021-12-27,LAC,,BRK,L 108-124,240,37,97,.381,23,60,.383,14,37,.378,20,27,.741,108,50,88,.568,37,54,.685,13,34,.382,11,16,.688,124
989,2021-12-27,BOS,@,MIN,L 103-108,240,33,89,.371,17,42,.405,16,47,.340,21,28,.750,103,40,90,.444,26,56,.464,14,34,.412,14,19,.737,108
990,2021-12-27,MIN,,BOS,W 108-103,240,40,90,.444,26,56,.464,14,34,.412,14,19,.737,108,33,89,.371,17,42,.405,16,47,.340,21,28,.750,103
991,2021-12-27,MEM,@,PHO,W 114-113,240,45,88,.511,34,59,.576,11,29,.379,13,17,.765,114,41,90,.456,30,59,.508,11,31,.355,20,23,.870,113
992,2021-12-27,PHO,,MEM,L 113-114,240,41,90,.456,30,59,.508,11,31,.355,20,23,.870,113,45,88,.511,34,59,.576,11,29,.379,13,17,.765,114
993,2021-12-27,DAL,@,POR,W 132-117,240,48,84,.571,36,51,.706,12,33,.364,24,33,.727,132,35,82,.427,23,42,.548,12,40,.300,35,42,.833,117
994,2021-12-27,POR,,DAL,L 117-132,240,35,82,.427,23,42,.548,12,40,.300,35,42,.833,117,48,84,.571,36,51,.706,12,33,.364,24,33,.727,132
995,2021-12-27,SAS,,UTA,L 104-110,240,45,100,.450,35,70,.500,10,30,.333,4,9,.444,104,39,86,.453,30,55,.545,9,31,.290,23,30,.767,110
996,2021-12-27,UTA,@,SAS,W 110-104,240,39,86,.453,30,55,.545,9,31,.290,23,30,.767,110,45,100,.450,35,70,.500,10,30,.333,4,9,.444,104
997,2021-12-28,DEN,@,GSW,W 89-86,240,34,83,.410,26,50,.520,8,33,.242,13,20,.650,89,30,72,.417,20,40,.500,10,32,.313,16,31,.516,86
998,2021-12-28,GSW,,DEN,L 86-89,240,30,72,.417,20,40,.500,10,32,.313,16,31,.516,86,34,83,.410,26,50,.520,8,33,.242,13,20,.650,89
999,2021-12-28,HOU,,LAL,L 123-132,240,44,83,.530,28,48,.583,16,35,.457,19,25,.760,123,48,92,.522,34,58,.586,14,34,.412,22,29,.759,132
1000,2021-12-28,LAL,@,HOU,W 132-123,240,48,92,.522,34,58,.586,14,34,.412,22,29,.759,132,44,83,.530,28,48,.583,16,35,.457,19,25,.760,123
1001,2021-12-28,MIA,,WAS,W 119-112,240,41,92,.446,25,58,.431,16,34,.471,21,23,.913,119,42,85,.494,25,43,.581,17,42,.405,11,14,.786,112
1002,2021-12-28,WAS,@,MIA,L 112-119,240,42,85,.494,25,43,.581,17,42,.405,11,14,.786,112,41,92,.446,25,58,.431,16,34,.471,21,23,.913,119
1003,2021-12-28,MIN,,NYK,L 88-96,240,34,85,.400,27,47,.574,7,38,.184,13,20,.650,88,37,90,.411,21,50,.420,16,40,.400,6,16,.375,96
1004,2021-12-28,NYK,@,MIN,W 96-88,240,37,90,.411,21,50,.420,16,40,.400,6,16,.375,96,34,85,.400,27,47,.574,7,38,.184,13,20,.650,88
1005,2021-12-28,CLE,@,NOP,L 104-108,240,37,88,.420,23,47,.489,14,41,.341,16,19,.842,104,36,80,.450,20,44,.455,16,36,.444,20,26,.769,108
1006,2021-12-28,NOP,,CLE,W 108-104,240,36,80,.450,20,44,.455,16,36,.444,20,26,.769,108,37,88,.420,23,47,.489,14,41,.341,16,19,.842,104
1007,2021-12-28,MIL,@,ORL,W 127-110,240,47,85,.553,30,48,.625,17,37,.459,16,22,.727,127,38,83,.458,26,44,.591,12,39,.308,22,26,.846,110
1008,2021-12-28,ORL,,MIL,L 110-127,240,38,83,.458,26,44,.591,12,39,.308,22,26,.846,110,47,85,.553,30,48,.625,17,37,.459,16,22,.727,127
1009,2021-12-28,OKC,@,SAC,L 111-117,240,35,90,.389,24,57,.421,11,33,.333,30,36,.833,111,40,95,.421,23,56,.411,17,39,.436,20,27,.741,117
1010,2021-12-28,SAC,,OKC,W 117-111,240,40,95,.421,23,56,.411,17,39,.436,20,27,.741,117,35,90,.389,24,57,.421,11,33,.333,30,36,.833,111
1011,2021-12-28,PHI,@,TOR,W 114-109,240,34,77,.442,20,47,.426,14,30,.467,32,38,.842,114,38,87,.437,23,46,.500,15,41,.366,18,22,.818,109
1012,2021-12-28,TOR,,PHI,L 109-114,240,38,87,.437,23,46,.500,15,41,.366,18,22,.818,109,34,77,.442,20,47,.426,14,30,.467,32,38,.842,114
1013,2021-12-29,BOS,,LAC,L 82-91,240,35,101,.347,31,59,.525,4,42,.095,8,11,.727,82,33,81,.407,22,53,.415,11,28,.393,14,17,.824,91
1014,2021-12-29,LAC,@,BOS,W 91-82,240,33,81,.407,22,53,.415,11,28,.393,14,17,.824,91,35,101,.347,31,59,.525,4,42,.095,8,11,.727,82
1015,2021-12-29,ATL,@,CHI,L 117-131,240,44,92,.478,33,66,.500,11,26,.423,18,26,.692,117,52,84,.619,42,62,.677,10,22,.455,17,22,.773,131
1016,2021-12-29,CHI,,ATL,W 131-117,240,52,84,.619,42,62,.677,10,22,.455,17,22,.773,131,44,92,.478,33,66,.500,11,26,.423,18,26,.692,117
1017,2021-12-29,DET,,NYK,L 85-94,240,30,81,.370,18,46,.391,12,35,.343,13,17,.765,85,31,81,.383,23,50,.460,8,31,.258,24,27,.889,94
1018,2021-12-29,NYK,@,DET,W 94-85,240,31,81,.383,23,50,.460,8,31,.258,24,27,.889,94,30,81,.370,18,46,.391,12,35,.343,13,17,.765,85
1019,2021-12-29,CHO,@,IND,W 116-108,240,44,85,.518,35,59,.593,9,26,.346,19,32,.594,116,36,86,.419,19,41,.463,17,45,.378,19,29,.655,108
1020,2021-12-29,IND,,CHO,L 108-116,240,36,86,.419,19,41,.463,17,45,.378,19,29,.655,108,44,85,.518,35,59,.593,9,26,.346,19,32,.594,116
1021,2021-12-29,LAL,@,MEM,L 99-104,240,39,86,.453,24,45,.533,15,41,.366,6,8,.750,99,35,85,.412,25,55,.455,10,30,.333,24,29,.828,104
1022,2021-12-29,MEM,,LAL,W 104-99,240,35,85,.412,25,55,.455,10,30,.333,24,29,.828,104,39,86,.453,24,45,.533,15,41,.366,6,8,.750,99
1023,2021-12-29,OKC,@,PHO,L 97-115,240,38,96,.396,31,61,.508,7,35,.200,14,16,.875,97,41,89,.461,29,55,.527,12,34,.353,21,28,.750,115
1024,2021-12-29,PHO,,OKC,W 115-97,240,41,89,.461,29,55,.527,12,34,.353,21,28,.750,115,38,96,.396,31,61,.508,7,35,.200,14,16,.875,97
1025,2021-12-29,POR,,UTA,L 105-120,240,37,88,.420,23,48,.479,14,40,.350,17,24,.708,105,46,87,.529,38,58,.655,8,29,.276,20,32,.625,120
1026,2021-12-29,UTA,@,POR,W 120-105,240,46,87,.529,38,58,.655,8,29,.276,20,32,.625,120,37,88,.420,23,48,.479,14,40,.350,17,24,.708,105
1027,2021-12-29,DAL,@,SAC,L 94-95,240,38,81,.469,29,57,.509,9,24,.375,9,13,.692,94,36,75,.480,26,49,.531,10,26,.385,13,15,.867,95
1028,2021-12-29,SAC,,DAL,W 95-94,240,36,75,.480,26,49,.531,10,26,.385,13,15,.867,95,38,81,.469,29,57,.509,9,24,.375,9,13,.692,94
1029,2021-12-30,BRK,,PHI,L 102-110,240,37,81,.457,30,54,.556,7,27,.259,21,27,.778,102,42,100,.420,29,68,.426,13,32,.406,13,20,.650,110
1030,2021-12-30,PHI,@,BRK,W 110-102,240,42,100,.420,29,68,.426,13,32,.406,13,20,.650,110,37,81,.457,30,54,.556,7,27,.259,21,27,.778,102
1031,2021-12-30,MIL,@,ORL,W 136-118,240,45,91,.495,32,58,.552,13,33,.394,33,36,.917,136,42,87,.483,29,51,.569,13,36,.361,21,27,.778,118
1032,2021-12-30,ORL,,MIL,L 118-136,240,42,87,.483,29,51,.569,13,36,.361,21,27,.778,118,45,91,.495,32,58,.552,13,33,.394,33,36,.917,136
1033,2021-12-30,CLE,@,WAS,L 93-110,240,35,83,.422,27,55,.491,8,28,.286,15,23,.652,93,45,90,.500,36,61,.590,9,29,.310,11,17,.647,110
1034,2021-12-30,WAS,,CLE,W 110-93,240,45,90,.500,36,61,.590,9,29,.310,11,17,.647,110,35,83,.422,27,55,.491,8,28,.286,15,23,.652,93
1035,2021-12-31,BOS,,PHO,W 123-108,240,45,83,.542,35,56,.625,10,27,.370,23,26,.885,123,41,100,.410,30,65,.462,11,35,.314,15,16,.938,108
1036,2021-12-31,PHO,@,BOS,L 108-123,240,41,100,.410,30,65,.462,11,35,.314,15,16,.938,108,45,83,.542,35,56,.625,10,27,.370,23,26,.885,123
1037,2021-12-31,ATL,@,CLE,W 121-118,240,43,97,.443,27,59,.458,16,38,.421,19,21,.905,121,48,84,.571,40,59,.678,8,25,.320,14,24,.583,118
1038,2021-12-31,CLE,,ATL,L 118-121,240,48,84,.571,40,59,.678,8,25,.320,14,24,.583,118,43,97,.443,27,59,.458,16,38,.421,19,21,.905,121
1039,2021-12-31,HOU,,MIA,L 110-120,240,41,93,.441,27,51,.529,14,42,.333,14,17,.824,110,40,86,.465,26,53,.491,14,33,.424,26,31,.839,120
1040,2021-12-31,MIA,@,HOU,W 120-110,240,40,86,.465,26,53,.491,14,33,.424,26,31,.839,120,41,93,.441,27,51,.529,14,42,.333,14,17,.824,110
1041,2021-12-31,CHI,@,IND,W 108-106,240,35,86,.407,23,59,.390,12,27,.444,26,30,.867,108,38,91,.418,30,60,.500,8,31,.258,22,29,.759,106
1042,2021-12-31,IND,,CHI,L 106-108,240,38,91,.418,30,60,.500,8,31,.258,22,29,.759,106,35,86,.407,23,59,.390,12,27,.444,26,30,.867,108
1043,2021-12-31,LAL,,POR,W 139-106,240,47,85,.553,28,44,.636,19,41,.463,26,30,.867,139,36,102,.353,24,60,.400,12,42,.286,22,27,.815,106
1044,2021-12-31,POR,@,LAL,L 106-139,240,36,102,.353,24,60,.400,12,42,.286,22,27,.815,106,47,85,.553,28,44,.636,19,41,.463,26,30,.867,139
1045,2021-12-31,MEM,,SAS,W 118-105,240,49,102,.480,39,76,.513,10,26,.385,10,16,.625,118,39,90,.433,27,55,.491,12,35,.343,15,24,.625,105
1046,2021-12-31,SAS,@,MEM,L 105-118,240,39,90,.433,27,55,.491,12,35,.343,15,24,.625,105,49,102,.480,39,76,.513,10,26,.385,10,16,.625,118
1047,2021-12-31,NYK,@,OKC,L 80-95,240,30,81,.370,22,40,.550,8,41,.195,12,22,.545,80,36,87,.414,18,44,.409,18,43,.419,5,7,.714,95
1048,2021-12-31,OKC,,NYK,W 95-80,240,36,87,.414,18,44,.409,18,43,.419,5,7,.714,95,30,81,.370,22,40,.550,8,41,.195,12,22,.545,80
1049,2021-12-31,DAL,@,SAC,W 112-96,240,42,81,.519,33,59,.559,9,22,.409,19,22,.864,112,38,91,.418,28,62,.452,10,29,.345,10,12,.833,96
1050,2021-12-31,SAC,,DAL,L 96-112,240,38,91,.418,28,62,.452,10,29,.345,10,12,.833,96,42,81,.519,33,59,.559,9,22,.409,19,22,.864,112
1051,2021-12-31,LAC,@,TOR,L 108-116,240,38,78,.487,23,44,.523,15,34,.441,17,19,.895,108,40,96,.417,29,61,.475,11,35,.314,25,33,.758,116
1052,2021-12-31,TOR,,LAC,W 116-108,240,40,96,.417,29,61,.475,11,35,.314,25,33,.758,116,38,78,.487,23,44,.523,15,34,.441,17,19,.895,108
1053,2021-12-31,MIN,@,UTA,L 108-120,240,40,93,.430,26,52,.500,14,41,.341,14,22,.636,108,37,78,.474,26,49,.531,11,29,.379,35,41,.854,120
1054,2021-12-31,UTA,,MIN,W 120-108,240,37,78,.474,26,49,.531,11,29,.379,35,41,.854,120,40,93,.430,26,52,.500,14,41,.341,14,22,.636,108
1055,2022-01-01,BRK,,LAC,L 116-120,240,42,97,.433,31,64,.484,11,33,.333,21,25,.840,116,42,86,.488,28,50,.560,14,36,.389,22,31,.710,120
1056,2022-01-01,LAC,@,BRK,W 120-116,240,42,86,.488,28,50,.560,14,36,.389,22,31,.710,120,42,97,.433,31,64,.484,11,33,.333,21,25,.840,116
1057,2022-01-01,DET,,SAS,W 117-116 (OT),265,41,101,.406,32,66,.485,9,35,.257,26,33,.788,117,42,102,.412,30,62,.484,12,40,.300,20,28,.714,116
1058,2022-01-01,SAS,@,DET,L 116-117 (OT),265,42,102,.412,30,62,.484,12,40,.300,20,28,.714,116,41,101,.406,32,66,.485,9,35,.257,26,33,.788,117
1059,2022-01-01,DEN,@,HOU,W 124-111,240,46,86,.535,36,54,.667,10,32,.313,22,27,.815,124,37,85,.435,21,43,.488,16,42,.381,21,24,.875,111
1060,2022-01-01,HOU,,DEN,L 111-124,240,37,85,.435,21,43,.488,16,42,.381,21,24,.875,111,46,86,.535,36,54,.667,10,32,.313,22,27,.815,124
1061,2022-01-01,MIL,,NOP,W 136-113,240,49,92,.533,26,44,.591,23,48,.479,15,18,.833,136,39,95,.411,23,44,.523,16,51,.314,19,30,.633,113
1062,2022-01-01,NOP,@,MIL,L 113-136,240,39,95,.411,23,44,.523,16,51,.314,19,30,.633,113,49,92,.533,26,44,.591,23,48,.479,15,18,.833,136
1063,2022-01-01,GSW,@,UTA,W 123-116,240,46,86,.535,29,54,.537,17,32,.531,14,21,.667,123,40,92,.435,26,48,.542,14,44,.318,22,28,.786,116
1064,2022-01-01,UTA,,GSW,L 116-123,240,40,92,.435,26,48,.542,14,44,.318,22,28,.786,116,46,86,.535,29,54,.537,17,32,.531,14,21,.667,123
1065,2022-01-01,CHI,@,WAS,W 120-119,240,41,84,.488,24,50,.480,17,34,.500,21,25,.840,120,46,87,.529,40,60,.667,6,27,.222,21,26,.808,119
1066,2022-01-01,WAS,,CHI,L 119-120,240,46,87,.529,40,60,.667,6,27,.222,21,26,.808,119,41,84,.488,24,50,.480,17,34,.500,21,25,.840,120
1067,2022-01-02,BOS,,ORL,W 116-111 (OT),265,39,86,.453,26,50,.520,13,36,.361,25,28,.893,116,40,95,.421,31,68,.456,9,27,.333,22,27,.815,111
1068,2022-01-02,ORL,@,BOS,L 111-116 (OT),265,40,95,.421,31,68,.456,9,27,.333,22,27,.815,111,39,86,.453,26,50,.520,13,36,.361,25,28,.893,116
1069,2022-01-02,CHO,,PHO,L 99-133,240,39,85,.459,30,50,.600,9,35,.257,12,21,.571,99,52,103,.505,35,62,.565,17,41,.415,12,12,1.000,133
1070,2022-01-02,PHO,@,CHO,W 133-99,240,52,103,.505,35,62,.565,17,41,.415,12,12,1.000,133,39,85,.459,30,50,.600,9,35,.257,12,21,.571,99
1071,2022-01-02,CLE,,IND,W 108-104,240,41,88,.466,35,62,.565,6,26,.231,20,28,.714,108,37,83,.446,18,37,.486,19,46,.413,11,14,.786,104
1072,2022-01-02,IND,@,CLE,L 104-108,240,37,83,.446,18,37,.486,19,46,.413,11,14,.786,104,41,88,.466,35,62,.565,6,26,.231,20,28,.714,108
1073,2022-01-02,LAL,,MIN,W 108-103,240,36,75,.480,23,34,.676,13,41,.317,23,29,.793,108,41,92,.446,32,54,.593,9,38,.237,12,16,.750,103
1074,2022-01-02,MIN,@,LAL,L 103-108,240,41,92,.446,32,54,.593,9,38,.237,12,16,.750,103,36,75,.480,23,34,.676,13,41,.317,23,29,.793,108
1075,2022-01-02,DAL,@,OKC,W 95-86,240,38,85,.447,24,46,.522,14,39,.359,5,7,.714,95,35,85,.412,25,55,.455,10,30,.333,6,9,.667,86
1076,2022-01-02,OKC,,DAL,L 86-95,240,35,85,.412,25,55,.455,10,30,.333,6,9,.667,86,38,85,.447,24,46,.522,14,39,.359,5,7,.714,95
1077,2022-01-02,MIA,@,SAC,L 113-115,240,46,105,.438,37,72,.514,9,33,.273,12,12,1.000,113,40,78,.513,27,44,.614,13,34,.382,22,27,.815,115
1078,2022-01-02,SAC,,MIA,W 115-113,240,40,78,.513,27,44,.614,13,34,.382,22,27,.815,115,46,105,.438,37,72,.514,9,33,.273,12,12,1.000,113
1079,2022-01-02,NYK,@,TOR,L 105-120,240,35,78,.449,23,42,.548,12,36,.333,23,28,.821,105,41,86,.477,28,52,.538,13,34,.382,25,30,.833,120
1080,2022-01-02,TOR,,NYK,W 120-105,240,41,86,.477,28,52,.538,13,34,.382,25,30,.833,120,35,78,.449,23,42,.548,12,36,.333,23,28,.821,105
1081,2022-01-03,BRK,,MEM,L 104-118,240,37,82,.451,28,51,.549,9,31,.290,21,26,.808,104,48,102,.471,38,67,.567,10,35,.286,12,21,.571,118
1082,2022-01-03,MEM,@,BRK,W 118-104,240,48,102,.471,38,67,.567,10,35,.286,12,21,.571,118,37,82,.451,28,51,.549,9,31,.290,21,26,.808,104
1083,2022-01-03,CHI,,ORL,W 102-98,240,37,86,.430,26,55,.473,11,31,.355,17,23,.739,102,36,85,.424,26,58,.448,10,27,.370,16,18,.889,98
1084,2022-01-03,ORL,@,CHI,L 98-102,240,36,85,.424,26,58,.448,10,27,.370,16,18,.889,98,37,86,.430,26,55,.473,11,31,.355,17,23,.739,102
1085,2022-01-03,DAL,,DEN,W 103-89,240,35,78,.449,21,41,.512,14,37,.378,19,21,.905,103,31,67,.463,25,42,.595,6,25,.240,21,29,.724,89
1086,2022-01-03,DEN,@,DAL,L 89-103,240,31,67,.463,25,42,.595,6,25,.240,21,29,.724,89,35,78,.449,21,41,.512,14,37,.378,19,21,.905,103
1087,2022-01-03,GSW,,MIA,W 115-108,240,45,92,.489,31,54,.574,14,38,.368,11,13,.846,115,37,90,.411,20,48,.417,17,42,.405,17,19,.895,108
1088,2022-01-03,MIA,@,GSW,L 108-115,240,37,90,.411,20,48,.417,17,42,.405,17,19,.895,108,45,92,.489,31,54,.574,14,38,.368,11,13,.846,115
1089,2022-01-03,LAC,,MIN,L 104-122,240,39,78,.500,28,46,.609,11,32,.344,15,17,.882,104,49,93,.527,33,48,.688,16,45,.356,8,9,.889,122
1090,2022-01-03,MIN,@,LAC,W 122-104,240,49,93,.527,33,48,.688,16,45,.356,8,9,.889,122,39,78,.500,28,46,.609,11,32,.344,15,17,.882,104
1091,2022-01-03,DET,@,MIL,W 115-106,240,44,91,.484,26,48,.542,18,43,.419,9,14,.643,115,39,92,.424,28,46,.609,11,46,.239,17,22,.773,106
1092,2022-01-03,MIL,,DET,L 106-115,240,39,92,.424,28,46,.609,11,46,.239,17,22,.773,106,44,91,.484,26,48,.542,18,43,.419,9,14,.643,115
1093,2022-01-03,NOP,,UTA,L 104-115,240,39,97,.402,27,51,.529,12,46,.261,14,22,.636,104,41,85,.482,22,46,.478,19,39,.487,14,17,.824,115
1094,2022-01-03,UTA,@,NOP,W 115-104,240,41,85,.482,22,46,.478,19,39,.487,14,17,.824,115,39,97,.402,27,51,.529,12,46,.261,14,22,.636,104
1095,2022-01-03,HOU,@,PHI,L 113-133,240,37,89,.416,22,45,.489,15,44,.341,24,33,.727,113,50,96,.521,33,56,.589,17,40,.425,16,17,.941,133
1096,2022-01-03,PHI,,HOU,W 133-113,240,50,96,.521,33,56,.589,17,40,.425,16,17,.941,133,37,89,.416,22,45,.489,15,44,.341,24,33,.727,113
1097,2022-01-03,ATL,@,POR,L 131-136,240,48,88,.545,34,47,.723,14,41,.341,21,24,.875,131,47,89,.528,29,48,.604,18,41,.439,24,28,.857,136
1098,2022-01-03,POR,,ATL,W 136-131,240,47,89,.528,29,48,.604,18,41,.439,24,28,.857,136,48,88,.545,34,47,.723,14,41,.341,21,24,.875,131
1099,2022-01-03,CHO,@,WAS,L 121-124,240,50,104,.481,36,66,.545,14,38,.368,7,13,.538,121,40,87,.460,24,49,.490,16,38,.421,28,31,.903,124
1100,2022-01-03,WAS,,CHO,W 124-121,240,40,87,.460,24,49,.490,16,38,.421,28,31,.903,124,50,104,.481,36,66,.545,14,38,.368,7,13,.538,121
1101,2022-01-04,CLE,,MEM,L 106-110,240,40,92,.435,30,58,.517,10,34,.294,16,21,.762,106,42,90,.467,33,63,.524,9,27,.333,17,22,.773,110
1102,2022-01-04,MEM,@,CLE,W 110-106,240,42,90,.467,33,63,.524,9,27,.333,17,22,.773,110,40,92,.435,30,58,.517,10,34,.294,16,21,.762,106
1103,2022-01-04,LAL,,SAC,W 122-114,240,49,99,.495,38,67,.567,11,32,.344,13,20,.650,122,43,83,.518,29,49,.592,14,34,.412,14,18,.778,114
1104,2022-01-04,SAC,@,LAL,L 114-122,240,43,83,.518,29,49,.592,14,34,.412,14,18,.778,114,49,99,.495,38,67,.567,11,32,.344,13,20,.650,122
1105,2022-01-04,NOP,,PHO,L 110-123,240,36,89,.404,26,56,.464,10,33,.303,28,32,.875,110,46,85,.541,29,54,.537,17,31,.548,14,20,.700,123
1106,2022-01-04,PHO,@,NOP,W 123-110,240,46,85,.541,29,54,.537,17,31,.548,14,20,.700,123,36,89,.404,26,56,.464,10,33,.303,28,32,.875,110
1107,2022-01-04,IND,@,NYK,L 94-104,240,32,76,.421,23,38,.605,9,38,.237,21,32,.656,94,39,80,.488,33,52,.635,6,28,.214,20,28,.714,104
1108,2022-01-04,NYK,,IND,W 104-94,240,39,80,.488,33,52,.635,6,28,.214,20,28,.714,104,32,76,.421,23,38,.605,9,38,.237,21,32,.656,94
1109,2022-01-04,SAS,@,TOR,L 104-129,240,41,95,.432,32,60,.533,9,35,.257,13,19,.684,104,45,96,.469,27,52,.519,18,44,.409,21,29,.724,129
1110,2022-01-04,TOR,,SAS,W 129-104,240,45,96,.469,27,52,.519,18,44,.409,21,29,.724,129,41,95,.432,32,60,.533,9,35,.257,13,19,.684,104
1111,2022-01-05,BOS,,SAS,L 97-99,240,40,90,.444,31,62,.500,9,28,.321,8,9,.889,97,42,88,.477,32,62,.516,10,26,.385,5,5,1.000,99
1112,2022-01-05,SAS,@,BOS,W 99-97,240,42,88,.477,32,62,.516,10,26,.385,5,5,1.000,99,40,90,.444,31,62,.500,9,28,.321,8,9,.889,97
1113,2022-01-05,CHO,,DET,W 140-111,240,48,81,.593,24,39,.615,24,42,.571,20,29,.690,140,43,92,.467,29,50,.580,14,42,.333,11,20,.550,111
1114,2022-01-05,DET,@,CHO,L 111-140,240,43,92,.467,29,50,.580,14,42,.333,11,20,.550,111,48,81,.593,24,39,.615,24,42,.571,20,29,.690,140
1115,2022-01-05,DAL,,GSW,W 99-82,240,33,87,.379,21,47,.447,12,40,.300,21,26,.808,99,33,81,.407,28,53,.528,5,28,.179,11,16,.688,82
1116,2022-01-05,GSW,@,DAL,L 82-99,240,33,81,.407,28,53,.528,5,28,.179,11,16,.688,82,33,87,.379,21,47,.447,12,40,.300,21,26,.808,99
1117,2022-01-05,DEN,,UTA,L 109-115,240,42,88,.477,31,52,.596,11,36,.306,14,15,.933,109,43,92,.467,29,51,.569,14,41,.341,15,18,.833,115
1118,2022-01-05,UTA,@,DEN,W 115-109,240,43,92,.467,29,51,.569,14,41,.341,15,18,.833,115,42,88,.477,31,52,.596,11,36,.306,14,15,.933,109
1119,2022-01-05,BRK,@,IND,W 129-121,240,49,86,.570,44,65,.677,5,21,.238,26,29,.897,129,41,82,.500,28,43,.651,13,39,.333,26,28,.929,121
1120,2022-01-05,IND,,BRK,L 121-129,240,41,82,.500,28,43,.651,13,39,.333,26,28,.929,121,49,86,.570,44,65,.677,5,21,.238,26,29,.897,129
1121,2022-01-05,MIL,,TOR,L 111-117,240,38,85,.447,21,46,.457,17,39,.436,18,26,.692,111,42,89,.472,26,53,.491,16,36,.444,17,25,.680,117
1122,2022-01-05,TOR,@,MIL,W 117-111,240,42,89,.472,26,53,.491,16,36,.444,17,25,.680,117,38,85,.447,21,46,.457,17,39,.436,18,26,.692,111
1123,2022-01-05,MIN,,OKC,W 98-90,240,36,90,.400,24,46,.522,12,44,.273,14,20,.700,98,33,90,.367,24,55,.436,9,35,.257,15,18,.833,90
1124,2022-01-05,OKC,@,MIN,L 90-98,240,33,90,.367,24,55,.436,9,35,.257,15,18,.833,90,36,90,.400,24,46,.522,12,44,.273,14,20,.700,98
1125,2022-01-05,ORL,,PHI,L 106-116,240,40,90,.444,28,51,.549,12,39,.308,14,20,.700,106,43,85,.506,31,57,.544,12,28,.429,18,24,.750,116
1126,2022-01-05,PHI,@,ORL,W 116-106,240,43,85,.506,31,57,.544,12,28,.429,18,24,.750,116,40,90,.444,28,51,.549,12,39,.308,14,20,.700,106
1127,2022-01-05,MIA,@,POR,W 115-109,240,37,82,.451,18,41,.439,19,41,.463,22,29,.759,115,33,78,.423,18,40,.450,15,38,.395,28,36,.778,109
1128,2022-01-05,POR,,MIA,L 109-115,240,33,78,.423,18,40,.450,15,38,.395,28,36,.778,109,37,82,.451,18,41,.439,19,41,.463,22,29,.759,115
1129,2022-01-05,ATL,@,SAC,W 108-102,240,39,86,.453,31,56,.554,8,30,.267,22,30,.733,108,38,90,.422,27,63,.429,11,27,.407,15,20,.750,102
1130,2022-01-05,SAC,,ATL,L 102-108,240,38,90,.422,27,63,.429,11,27,.407,15,20,.750,102,39,86,.453,31,56,.554,8,30,.267,22,30,.733,108
1131,2022-01-05,HOU,@,WAS,W 114-111,240,40,85,.471,31,59,.525,9,26,.346,25,32,.781,114,40,91,.440,30,52,.577,10,39,.256,21,26,.808,111
1132,2022-01-05,WAS,,HOU,L 111-114,240,40,91,.440,30,52,.577,10,39,.256,21,26,.808,111,40,85,.471,31,59,.525,9,26,.346,25,32,.781,114
1133,2022-01-06,DET,@,MEM,L 88-118,240,34,99,.343,24,55,.436,10,44,.227,10,13,.769,88,48,98,.490,38,66,.576,10,32,.313,12,19,.632,118
1134,2022-01-06,MEM,,DET,W 118-88,240,48,98,.490,38,66,.576,10,32,.313,12,19,.632,118,34,99,.343,24,55,.436,10,44,.227,10,13,.769,88
1135,2022-01-06,GSW,@,NOP,L 96-101,240,37,87,.425,30,54,.556,7,33,.212,15,18,.833,96,35,83,.422,27,49,.551,8,34,.235,23,29,.793,101
1136,2022-01-06,NOP,,GSW,W 101-96,240,35,83,.422,27,49,.551,8,34,.235,23,29,.793,101,37,87,.425,30,54,.556,7,33,.212,15,18,.833,96
1137,2022-01-06,BOS,@,NYK,L 105-108,240,38,80,.475,21,35,.600,17,45,.378,12,13,.923,105,40,90,.444,22,54,.407,18,36,.500,10,15,.667,108
1138,2022-01-06,NYK,,BOS,W 108-105,240,40,90,.444,22,54,.407,18,36,.500,10,15,.667,108,38,80,.475,21,35,.600,17,45,.378,12,13,.923,105
1139,2022-01-06,LAC,@,PHO,L 89-106,240,31,86,.360,25,58,.431,6,28,.214,21,25,.840,89,44,107,.411,34,76,.447,10,31,.323,8,10,.800,106
1140,2022-01-06,PHO,,LAC,W 106-89,240,44,107,.411,34,76,.447,10,31,.323,8,10,.800,106,31,86,.360,25,58,.431,6,28,.214,21,25,.840,89
1141,2022-01-07,BRK,,MIL,L 109-121,240,42,92,.457,36,65,.554,6,27,.222,19,20,.950,109,44,96,.458,28,51,.549,16,45,.356,17,21,.810,121
1142,2022-01-07,MIL,@,BRK,W 121-109,240,44,96,.458,28,51,.549,16,45,.356,17,21,.810,121,42,92,.457,36,65,.554,6,27,.222,19,20,.950,109
1143,2022-01-07,CHI,,WAS,W 130-122,240,48,91,.527,33,58,.569,15,33,.455,19,21,.905,130,45,88,.511,38,64,.594,7,24,.292,25,26,.962,122
1144,2022-01-07,WAS,@,CHI,L 122-130,240,45,88,.511,38,64,.594,7,24,.292,25,26,.962,122,48,91,.527,33,58,.569,15,33,.455,19,21,.905,130
1145,2022-01-07,DEN,,SAC,W 121-111,240,47,85,.553,35,51,.686,12,34,.353,15,24,.625,121,40,92,.435,29,63,.460,11,29,.379,20,24,.833,111
1146,2022-01-07,SAC,@,DEN,L 111-121,240,40,92,.435,29,63,.460,11,29,.379,20,24,.833,111,47,85,.553,35,51,.686,12,34,.353,15,24,.625,121
1147,2022-01-07,DAL,@,HOU,W 130-106,240,49,90,.544,32,52,.615,17,38,.447,15,28,.536,130,37,87,.425,25,44,.568,12,43,.279,20,29,.690,106
1148,2022-01-07,HOU,,DAL,L 106-130,240,37,87,.425,25,44,.568,12,43,.279,20,29,.690,106,49,90,.544,32,52,.615,17,38,.447,15,28,.536,130
1149,2022-01-07,ATL,@,LAL,L 118-134,240,43,96,.448,30,60,.500,13,36,.361,19,27,.704,118,50,101,.495,33,60,.550,17,41,.415,17,19,.895,134
1150,2022-01-07,LAL,,ATL,W 134-118,240,50,101,.495,33,60,.550,17,41,.415,17,19,.895,134,43,96,.448,30,60,.500,13,36,.361,19,27,.704,118
1151,2022-01-07,MIN,@,OKC,W 135-105,240,50,90,.556,33,49,.673,17,41,.415,18,25,.720,135,36,89,.404,21,45,.467,15,44,.341,18,23,.783,105
1152,2022-01-07,OKC,,MIN,L 105-135,240,36,89,.404,21,45,.467,15,44,.341,18,23,.783,105,50,90,.556,33,49,.673,17,41,.415,18,25,.720,135
1153,2022-01-07,PHI,,SAS,W 119-100,240,45,87,.517,37,64,.578,8,23,.348,21,27,.778,119,38,92,.413,29,62,.468,9,30,.300,15,20,.750,100
1154,2022-01-07,SAS,@,PHI,L 100-119,240,38,92,.413,29,62,.468,9,30,.300,15,20,.750,100,45,87,.517,37,64,.578,8,23,.348,21,27,.778,119
1155,2022-01-07,CLE,@,POR,W 114-101,240,39,80,.488,22,41,.537,17,39,.436,19,29,.655,114,37,92,.402,21,57,.368,16,35,.457,11,19,.579,101
1156,2022-01-07,POR,,CLE,L 101-114,240,37,92,.402,21,57,.368,16,35,.457,11,19,.579,101,39,80,.488,22,41,.537,17,39,.436,19,29,.655,114
1157,2022-01-07,TOR,,UTA,W 122-108,240,45,100,.450,33,59,.559,12,41,.293,20,25,.800,122,39,81,.481,22,43,.512,17,38,.447,13,18,.722,108
1158,2022-01-07,UTA,@,TOR,L 108-122,240,39,81,.481,22,43,.512,17,38,.447,13,18,.722,108,45,100,.450,33,59,.559,12,41,.293,20,25,.800,122
1159,2022-01-08,BOS,,NYK,W 99-75,240,36,76,.474,24,47,.511,12,29,.414,15,17,.882,99,29,79,.367,18,48,.375,11,31,.355,6,15,.400,75
1160,2022-01-08,NYK,@,BOS,L 75-99,240,29,79,.367,18,48,.375,11,31,.355,6,15,.400,75,36,76,.474,24,47,.511,12,29,.414,15,17,.882,99
1161,2022-01-08,CHO,,MIL,W 114-106,240,44,99,.444,28,51,.549,16,48,.333,10,17,.588,114,35,90,.389,23,53,.434,12,37,.324,24,26,.923,106
1162,2022-01-08,MIL,@,CHO,L 106-114,240,35,90,.389,23,53,.434,12,37,.324,24,26,.923,106,44,99,.444,28,51,.549,16,48,.333,10,17,.588,114
1163,2022-01-08,DET,,ORL,W 97-92,240,38,87,.437,28,54,.519,10,33,.303,11,16,.688,97,29,86,.337,15,40,.375,14,46,.304,20,23,.870,92
1164,2022-01-08,ORL,@,DET,L 92-97,240,29,86,.337,15,40,.375,14,46,.304,20,23,.870,92,38,87,.437,28,54,.519,10,33,.303,11,16,.688,97
1165,2022-01-08,IND,,UTA,W 125-113,240,44,80,.550,30,51,.588,14,29,.483,23,32,.719,125,40,84,.476,25,49,.510,15,35,.429,18,19,.947,113
1166,2022-01-08,UTA,@,IND,L 113-125,240,40,84,.476,25,49,.510,15,35,.429,18,19,.947,113,44,80,.550,30,51,.588,14,29,.483,23,32,.719,125
1167,2022-01-08,LAC,,MEM,L 108-123,240,39,96,.406,29,64,.453,10,32,.313,20,24,.833,108,44,100,.440,32,62,.516,12,38,.316,23,31,.742,123
1168,2022-01-08,MEM,@,LAC,W 123-108,240,44,100,.440,32,62,.516,12,38,.316,23,31,.742,123,39,96,.406,29,64,.453,10,32,.313,20,24,.833,108
1169,2022-01-08,MIA,@,PHO,W 123-100,240,44,88,.500,22,44,.500,22,44,.500,13,15,.867,123,30,79,.380,16,45,.356,14,34,.412,26,29,.897,100
1170,2022-01-08,PHO,,MIA,L 100-123,240,30,79,.380,16,45,.356,14,34,.412,26,29,.897,100,44,88,.500,22,44,.500,22,44,.500,13,15,.867,123
1171,2022-01-09,BRK,,SAS,W 121-119 (OT),265,47,98,.480,39,70,.557,8,28,.286,19,22,.864,121,46,107,.430,33,75,.440,13,32,.406,14,18,.778,119
1172,2022-01-09,SAS,@,BRK,L 119-121 (OT),265,46,107,.430,33,75,.440,13,32,.406,14,18,.778,119,47,98,.480,39,70,.557,8,28,.286,19,22,.864,121
1173,2022-01-09,CHI,@,DAL,L 99-113,240,39,90,.433,28,57,.491,11,33,.333,10,13,.769,99,44,88,.500,28,52,.538,16,36,.444,9,9,1.000,113
1174,2022-01-09,DAL,,CHI,W 113-99,240,44,88,.500,28,52,.538,16,36,.444,9,9,1.000,113,39,90,.433,28,57,.491,11,33,.333,10,13,.769,99
1175,2022-01-09,CLE,@,GSW,L 82-96,240,32,75,.427,25,51,.490,7,24,.292,11,18,.611,82,39,97,.402,29,55,.527,10,42,.238,8,10,.800,96
1176,2022-01-09,GSW,,CLE,W 96-82,240,39,97,.402,29,55,.527,10,42,.238,8,10,.800,96,32,75,.427,25,51,.490,7,24,.292,11,18,.611,82
1177,2022-01-09,HOU,,MIN,L 123-141,240,46,97,.474,32,54,.593,14,43,.326,17,28,.607,123,55,108,.509,40,66,.606,15,42,.357,16,21,.762,141
1178,2022-01-09,MIN,@,HOU,W 141-123,240,55,108,.509,40,66,.606,15,42,.357,16,21,.762,141,46,97,.474,32,54,.593,14,43,.326,17,28,.607,123
1179,2022-01-09,ATL,@,LAC,L 93-106,240,35,78,.449,28,52,.538,7,26,.269,16,19,.842,93,44,92,.478,32,59,.542,12,33,.364,6,7,.857,106
1180,2022-01-09,LAC,,ATL,W 106-93,240,44,92,.478,32,59,.542,12,33,.364,6,7,.857,106,35,78,.449,28,52,.538,7,26,.269,16,19,.842,93
1181,2022-01-09,LAL,,MEM,L 119-127,240,45,97,.464,31,64,.484,14,33,.424,15,19,.789,119,47,86,.547,36,56,.643,11,30,.367,22,32,.688,127
1182,2022-01-09,MEM,@,LAL,W 127-119,240,47,86,.547,36,56,.643,11,30,.367,22,32,.688,127,45,97,.464,31,64,.484,14,33,.424,15,19,.789,119
1183,2022-01-09,DEN,@,OKC,W 99-95,240,37,89,.416,24,53,.453,13,36,.361,12,16,.750,99,38,88,.432,29,50,.580,9,38,.237,10,12,.833,95
1184,2022-01-09,OKC,,DEN,L 95-99,240,38,88,.432,29,50,.580,9,38,.237,10,12,.833,95,37,89,.416,24,53,.453,13,36,.361,12,16,.750,99
1185,2022-01-09,ORL,,WAS,L 100-102,240,38,95,.400,29,67,.433,9,28,.321,15,16,.938,100,36,88,.409,25,59,.424,11,29,.379,19,24,.792,102
1186,2022-01-09,WAS,@,ORL,W 102-100,240,36,88,.409,25,59,.424,11,29,.379,19,24,.792,102,38,95,.400,29,67,.433,9,28,.321,15,16,.938,100
1187,2022-01-09,POR,,SAC,W 103-88,240,37,88,.420,20,48,.417,17,40,.425,12,15,.800,103,33,85,.388,26,54,.481,7,31,.226,15,21,.714,88
1188,2022-01-09,SAC,@,POR,L 88-103,240,33,85,.388,26,54,.481,7,31,.226,15,21,.714,88,37,88,.420,20,48,.417,17,40,.425,12,15,.800,103
1189,2022-01-09,NOP,@,TOR,L 101-105,240,34,75,.453,22,42,.524,12,33,.364,21,25,.840,101,36,85,.424,22,51,.431,14,34,.412,19,20,.950,105
1190,2022-01-09,TOR,,NOP,W 105-101,240,36,85,.424,22,51,.431,14,34,.412,19,20,.950,105,34,75,.453,22,42,.524,12,33,.364,21,25,.840,101
1191,2022-01-10,BOS,,IND,W 101-98 (OT),265,35,88,.398,27,60,.450,8,28,.286,23,28,.821,101,36,94,.383,25,57,.439,11,37,.297,15,17,.882,98
1192,2022-01-10,IND,@,BOS,L 98-101 (OT),265,36,94,.383,25,57,.439,11,37,.297,15,17,.882,98,35,88,.398,27,60,.450,8,28,.286,23,28,.821,101
1193,2022-01-10,CHO,,MIL,W 103-99,240,38,96,.396,25,52,.481,13,44,.295,14,16,.875,103,37,84,.440,24,41,.585,13,43,.302,12,16,.750,99
1194,2022-01-10,MIL,@,CHO,L 99-103,240,37,84,.440,24,41,.585,13,43,.302,12,16,.750,99,38,96,.396,25,52,.481,13,44,.295,14,16,.875,103
1195,2022-01-10,DET,,UTA,W 126-116,240,48,93,.516,29,56,.518,19,37,.514,11,12,.917,126,44,86,.512,33,53,.623,11,33,.333,17,22,.773,116
1196,2022-01-10,UTA,@,DET,L 116-126,240,44,86,.512,33,53,.623,11,33,.333,17,22,.773,116,48,93,.516,29,56,.518,19,37,.514,11,12,.917,126
1197,2022-01-10,HOU,,PHI,L 91-111,240,30,77,.390,17,35,.486,13,42,.310,18,27,.667,91,43,94,.457,33,59,.559,10,35,.286,15,18,.833,111
1198,2022-01-10,PHI,@,HOU,W 111-91,240,43,94,.457,33,59,.559,10,35,.286,15,18,.833,111,30,77,.390,17,35,.486,13,42,.310,18,27,.667,91
1199,2022-01-10,NYK,,SAS,W 111-96,240,40,82,.488,27,50,.540,13,32,.406,18,24,.750,111,39,95,.411,31,66,.470,8,29,.276,10,15,.667,96
1200,2022-01-10,SAS,@,NYK,L 96-111,240,39,95,.411,31,66,.470,8,29,.276,10,15,.667,96,40,82,.488,27,50,.540,13,32,.406,18,24,.750,111
1201,2022-01-10,BRK,@,POR,L 108-114,240,42,91,.462,30,59,.508,12,32,.375,12,15,.800,108,40,86,.465,25,48,.521,15,38,.395,19,26,.731,114
1202,2022-01-10,POR,,BRK,W 114-108,240,40,86,.465,25,48,.521,15,38,.395,19,26,.731,114,42,91,.462,30,59,.508,12,32,.375,12,15,.800,108
1203,2022-01-10,CLE,@,SAC,W 109-108,240,43,87,.494,33,53,.623,10,34,.294,13,15,.867,109,39,91,.429,25,61,.410,14,30,.467,16,22,.727,108
1204,2022-01-10,SAC,,CLE,L 108-109,240,39,91,.429,25,61,.410,14,30,.467,16,22,.727,108,43,87,.494,33,53,.623,10,34,.294,13,15,.867,109
1205,2022-01-11,CHI,,DET,W 133-87,240,50,92,.543,32,58,.552,18,34,.529,15,19,.789,133,30,89,.337,24,54,.444,6,35,.171,21,27,.778,87
1206,2022-01-11,DET,@,CHI,L 87-133,240,30,89,.337,24,54,.444,6,35,.171,21,27,.778,87,50,92,.543,32,58,.552,18,34,.529,15,19,.789,133
1207,2022-01-11,DEN,@,LAC,L 85-87,240,32,80,.400,28,47,.596,4,33,.121,17,20,.850,85,34,84,.405,24,50,.480,10,34,.294,9,12,.750,87
1208,2022-01-11,LAC,,DEN,W 87-85,240,34,84,.405,24,50,.480,10,34,.294,9,12,.750,87,32,80,.400,28,47,.596,4,33,.121,17,20,.850,85
1209,2022-01-11,GSW,@,MEM,L 108-116,240,35,82,.427,22,46,.478,13,36,.361,25,29,.862,108,44,100,.440,30,66,.455,14,34,.412,14,18,.778,116
1210,2022-01-11,MEM,,GSW,W 116-108,240,44,100,.440,30,66,.455,14,34,.412,14,18,.778,116,35,82,.427,22,46,.478,13,36,.361,25,29,.862,108
1211,2022-01-11,MIN,@,NOP,L 125-128,240,42,86,.488,24,47,.511,18,39,.462,23,31,.742,125,42,76,.553,26,43,.605,16,33,.485,28,37,.757,128
1212,2022-01-11,NOP,,MIN,W 128-125,240,42,76,.553,26,43,.605,16,33,.485,28,37,.757,128,42,86,.488,24,47,.511,18,39,.462,23,31,.742,125
1213,2022-01-11,PHO,@,TOR,W 99-95,240,35,74,.473,24,42,.571,11,32,.344,18,22,.818,99,36,89,.404,28,52,.538,8,37,.216,15,25,.600,95
1214,2022-01-11,TOR,,PHO,L 95-99,240,36,89,.404,28,52,.538,8,37,.216,15,25,.600,95,35,74,.473,24,42,.571,11,32,.344,18,22,.818,99
1215,2022-01-11,OKC,@,WAS,L 118-122,240,47,98,.480,36,59,.610,11,39,.282,13,15,.867,118,47,87,.540,36,54,.667,11,33,.333,17,23,.739,122
1216,2022-01-11,WAS,,OKC,W 122-118,240,47,87,.540,36,54,.667,11,33,.333,17,23,.739,122,47,98,.480,36,59,.610,11,39,.282,13,15,.867,118
1217,2022-01-12,ATL,,MIA,L 91-115,240,31,82,.378,18,37,.486,13,45,.289,16,23,.696,91,43,90,.478,27,45,.600,16,45,.356,13,14,.929,115
1218,2022-01-12,MIA,@,ATL,W 115-91,240,43,90,.478,27,45,.600,16,45,.356,13,14,.929,115,31,82,.378,18,37,.486,13,45,.289,16,23,.696,91
1219,2022-01-12,BRK,@,CHI,W 138-112,240,49,87,.563,32,55,.582,17,32,.531,23,28,.821,138,38,81,.469,27,51,.529,11,30,.367,25,31,.806,112
1220,2022-01-12,CHI,,BRK,L 112-138,240,38,81,.469,27,51,.529,11,30,.367,25,31,.806,112,49,87,.563,32,55,.582,17,32,.531,23,28,.821,138
1221,2022-01-12,BOS,@,IND,W 119-100,240,40,78,.513,22,40,.550,18,38,.474,21,25,.840,119,40,86,.465,33,50,.660,7,36,.194,13,20,.650,100
1222,2022-01-12,IND,,BOS,L 100-119,240,40,86,.465,33,50,.660,7,36,.194,13,20,.650,100,40,78,.513,22,40,.550,18,38,.474,21,25,.840,119
1223,2022-01-12,DAL,@,NYK,L 85-108,240,32,78,.410,24,41,.585,8,37,.216,13,19,.684,85,42,90,.467,30,63,.476,12,27,.444,12,15,.800,108
1224,2022-01-12,NYK,,DAL,W 108-85,240,42,90,.467,30,63,.476,12,27,.444,12,15,.800,108,32,78,.410,24,41,.585,8,37,.216,13,19,.684,85
1225,2022-01-12,CHO,@,PHI,W 109-98,240,46,89,.517,36,55,.655,10,34,.294,7,8,.875,109,34,73,.466,22,43,.512,12,30,.400,18,28,.643,98
1226,2022-01-12,PHI,,CHO,L 98-109,240,34,73,.466,22,43,.512,12,30,.400,18,28,.643,98,46,89,.517,36,55,.655,10,34,.294,7,8,.875,109
1227,2022-01-12,LAL,@,SAC,L 116-125,240,42,98,.429,26,51,.510,16,47,.340,16,24,.667,116,49,89,.551,38,59,.644,11,30,.367,16,19,.842,125
1228,2022-01-12,SAC,,LAL,W 125-116,240,49,89,.551,38,59,.644,11,30,.367,16,19,.842,125,42,98,.429,26,51,.510,16,47,.340,16,24,.667,116
1229,2022-01-12,HOU,@,SAS,W 128-124,240,45,82,.549,29,46,.630,16,36,.444,22,32,.688,128,43,99,.434,26,53,.491,17,46,.370,21,27,.778,124
1230,2022-01-12,SAS,,HOU,L 124-128,240,43,99,.434,26,53,.491,17,46,.370,21,27,.778,124,45,82,.549,29,46,.630,16,36,.444,22,32,.688,128
1231,2022-01-12,CLE,@,UTA,W 111-91,240,43,81,.531,32,51,.627,11,30,.367,14,17,.824,111,34,85,.400,18,38,.474,16,47,.340,7,11,.636,91
1232,2022-01-12,UTA,,CLE,L 91-111,240,34,85,.400,18,38,.474,16,47,.340,7,11,.636,91,43,81,.531,32,51,.627,11,30,.367,14,17,.824,111
1233,2022-01-12,ORL,@,WAS,L 106-112,240,41,99,.414,30,64,.469,11,35,.314,13,16,.813,106,43,82,.524,33,51,.647,10,31,.323,16,21,.762,112
1234,2022-01-12,WAS,,ORL,W 112-106,240,43,82,.524,33,51,.647,10,31,.323,16,21,.762,112,41,99,.414,30,64,.469,11,35,.314,13,16,.813,106
1235,2022-01-13,BRK,,OKC,L 109-130,240,41,98,.418,34,66,.515,7,32,.219,20,22,.909,109,47,91,.516,27,46,.587,20,45,.444,16,18,.889,130
1236,2022-01-13,OKC,@,BRK,W 130-109,240,47,91,.516,27,46,.587,20,45,.444,16,18,.889,130,41,98,.418,34,66,.515,7,32,.219,20,22,.909,109
1237,2022-01-13,DEN,,POR,W 140-108,240,52,83,.627,31,41,.756,21,42,.500,15,20,.750,140,39,86,.453,26,46,.565,13,40,.325,17,28,.607,108
1238,2022-01-13,POR,@,DEN,L 108-140,240,39,86,.453,26,46,.565,13,40,.325,17,28,.607,108,52,83,.627,31,41,.756,21,42,.500,15,20,.750,140
1239,2022-01-13,MEM,,MIN,W 116-108,240,42,92,.457,34,60,.567,8,32,.250,24,35,.686,116,41,96,.427,26,48,.542,15,48,.313,11,14,.786,108
1240,2022-01-13,MIN,@,MEM,L 108-116,240,41,96,.427,26,48,.542,15,48,.313,11,14,.786,108,42,92,.457,34,60,.567,8,32,.250,24,35,.686,116
1241,2022-01-13,GSW,@,MIL,L 99-118,240,33,95,.347,17,47,.362,16,48,.333,17,24,.708,99,44,86,.512,26,45,.578,18,41,.439,12,18,.667,118
1242,2022-01-13,MIL,,GSW,W 118-99,240,44,86,.512,26,45,.578,18,41,.439,12,18,.667,118,33,95,.347,17,47,.362,16,48,.333,17,24,.708,99
1243,2022-01-13,LAC,@,NOP,L 89-113,240,31,81,.383,21,47,.447,10,34,.294,17,20,.850,89,43,97,.443,29,58,.500,14,39,.359,13,16,.813,113
1244,2022-01-13,NOP,,LAC,W 113-89,240,43,97,.443,29,58,.500,14,39,.359,13,16,.813,113,31,81,.383,21,47,.447,10,34,.294,17,20,.850,89
1245,2022-01-14,CHI,,GSW,L 96-138,240,37,87,.425,27,49,.551,10,38,.263,12,18,.667,96,53,94,.564,34,52,.654,19,42,.452,13,17,.765,138
1246,2022-01-14,GSW,@,CHI,W 138-96,240,53,94,.564,34,52,.654,19,42,.452,13,17,.765,138,37,87,.425,27,49,.551,10,38,.263,12,18,.667,96
1247,2022-01-14,CHO,,ORL,L 109-116,240,40,97,.412,28,55,.509,12,42,.286,17,21,.810,109,45,87,.517,30,42,.714,15,45,.333,11,15,.733,116
1248,2022-01-14,ORL,@,CHO,W 116-109,240,45,87,.517,30,42,.714,15,45,.333,11,15,.733,116,40,97,.412,28,55,.509,12,42,.286,17,21,.810,109
1249,2022-01-14,DET,,TOR,W 103-87,240,38,81,.469,30,54,.556,8,27,.296,19,23,.826,103,28,87,.322,17,49,.347,11,38,.289,20,26,.769,87
1250,2022-01-14,TOR,@,DET,L 87-103,240,28,87,.322,17,49,.347,11,38,.289,20,26,.769,87,38,81,.469,30,54,.556,8,27,.296,19,23,.826,103
1251,2022-01-14,IND,,PHO,L 94-112,240,34,88,.386,21,45,.467,13,43,.302,13,18,.722,94,40,88,.455,29,60,.483,11,28,.393,21,23,.913,112
1252,2022-01-14,PHO,@,IND,W 112-94,240,40,88,.455,29,60,.483,11,28,.393,21,23,.913,112,34,88,.386,21,45,.467,13,43,.302,13,18,.722,94
1253,2022-01-14,DAL,@,MEM,W 112-85,240,47,91,.516,39,59,.661,8,32,.250,10,16,.625,112,34,89,.382,27,58,.466,7,31,.226,10,13,.769,85
1254,2022-01-14,MEM,,DAL,L 85-112,240,34,89,.382,27,58,.466,7,31,.226,10,13,.769,85,47,91,.516,39,59,.661,8,32,.250,10,16,.625,112
1255,2022-01-14,ATL,@,MIA,L 118-124,240,38,79,.481,22,41,.537,16,38,.421,26,30,.867,118,41,77,.532,27,47,.574,14,30,.467,28,30,.933,124
1256,2022-01-14,MIA,,ATL,W 124-118,240,41,77,.532,27,47,.574,14,30,.467,28,30,.933,124,38,79,.481,22,41,.537,16,38,.421,26,30,.867,118
1257,2022-01-14,BOS,@,PHI,L 99-111,240,37,78,.474,26,47,.553,11,31,.355,14,18,.778,99,38,85,.447,24,44,.545,14,41,.341,21,25,.840,111
1258,2022-01-14,PHI,,BOS,W 111-99,240,38,85,.447,24,44,.545,14,41,.341,21,25,.840,111,37,78,.474,26,47,.553,11,31,.355,14,18,.778,99
1259,2022-01-14,HOU,@,SAC,L 114-126,240,44,101,.436,31,58,.534,13,43,.302,13,16,.813,114,48,96,.500,35,59,.593,13,37,.351,17,24,.708,126
1260,2022-01-14,SAC,,HOU,W 126-114,240,48,96,.500,35,59,.593,13,37,.351,17,24,.708,126,44,101,.436,31,58,.534,13,43,.302,13,16,.813,114
1261,2022-01-14,CLE,@,SAS,W 114-109,240,46,95,.484,38,75,.507,8,20,.400,14,24,.583,114,42,92,.457,27,58,.466,15,34,.441,10,13,.769,109
1262,2022-01-14,SAS,,CLE,L 109-114,240,42,92,.457,27,58,.466,15,34,.441,10,13,.769,109,46,95,.484,38,75,.507,8,20,.400,14,24,.583,114
1263,2022-01-15,ATL,,NYK,L 108-117,240,40,80,.500,24,36,.667,16,44,.364,12,17,.706,108,42,83,.506,29,52,.558,13,31,.419,20,26,.769,117
1264,2022-01-15,NYK,@,ATL,W 117-108,240,42,83,.506,29,52,.558,13,31,.419,20,26,.769,117,40,80,.500,24,36,.667,16,44,.364,12,17,.706,108
1265,2022-01-15,BOS,,CHI,W 114-112,240,44,90,.489,35,64,.547,9,26,.346,17,19,.895,114,44,87,.506,32,58,.552,12,29,.414,12,15,.800,112
1266,2022-01-15,CHI,@,BOS,L 112-114,240,44,87,.506,32,58,.552,12,29,.414,12,15,.800,112,44,90,.489,35,64,.547,9,26,.346,17,19,.895,114
1267,2022-01-15,BRK,,NOP,W 120-105,240,46,84,.548,34,57,.596,12,27,.444,16,17,.941,120,40,87,.460,31,56,.554,9,31,.290,16,24,.667,105
1268,2022-01-15,NOP,@,BRK,L 105-120,240,40,87,.460,31,56,.554,9,31,.290,16,24,.667,105,46,84,.548,34,57,.596,12,27,.444,16,17,.941,120
1269,2022-01-15,DAL,,ORL,W 108-92,240,32,78,.410,20,44,.455,12,34,.353,32,38,.842,108,37,77,.481,30,51,.588,7,26,.269,11,16,.688,92
1270,2022-01-15,ORL,@,DAL,L 92-108,240,37,77,.481,30,51,.588,7,26,.269,11,16,.688,92,32,78,.410,20,44,.455,12,34,.353,32,38,.842,108
1271,2022-01-15,DEN,,LAL,W 133-96,240,47,91,.516,24,51,.471,23,40,.575,16,17,.941,133,36,82,.439,26,52,.500,10,30,.333,14,19,.737,96
1272,2022-01-15,LAL,@,DEN,L 96-133,240,36,82,.439,26,52,.500,10,30,.333,14,19,.737,96,47,91,.516,24,51,.471,23,40,.575,16,17,.941,133
1273,2022-01-15,MIA,,PHI,L 98-109,240,33,86,.384,24,51,.471,9,35,.257,23,30,.767,98,40,79,.506,27,47,.574,13,32,.406,16,21,.762,109
1274,2022-01-15,PHI,@,MIA,W 109-98,240,40,79,.506,27,47,.574,13,32,.406,16,21,.762,109,33,86,.384,24,51,.471,9,35,.257,23,30,.767,98
1275,2022-01-15,MIL,,TOR,L 96-103,240,26,77,.338,14,38,.368,12,39,.308,32,35,.914,96,40,91,.440,28,56,.500,12,35,.343,11,20,.550,103
1276,2022-01-15,TOR,@,MIL,W 103-96,240,40,91,.440,28,56,.500,12,35,.343,11,20,.550,103,26,77,.338,14,38,.368,12,39,.308,32,35,.914,96
1277,2022-01-15,CLE,@,OKC,W 107-102,240,40,87,.460,31,52,.596,9,35,.257,18,25,.720,107,36,83,.434,26,56,.464,10,27,.370,20,22,.909,102
1278,2022-01-15,OKC,,CLE,L 102-107,240,36,83,.434,26,56,.464,10,27,.370,20,22,.909,102,40,87,.460,31,52,.596,9,35,.257,18,25,.720,107
1279,2022-01-15,LAC,@,SAS,L 94-101,240,38,100,.380,26,62,.419,12,38,.316,6,8,.750,94,34,83,.410,23,46,.500,11,37,.297,22,27,.815,101
1280,2022-01-15,SAS,,LAC,W 101-94,240,34,83,.410,23,46,.500,11,37,.297,22,27,.815,101,38,100,.380,26,62,.419,12,38,.316,6,8,.750,94
1281,2022-01-15,POR,@,WAS,W 115-110,240,39,85,.459,26,46,.565,13,39,.333,24,35,.686,115,39,90,.433,27,53,.509,12,37,.324,20,23,.870,110
1282,2022-01-15,WAS,,POR,L 110-115,240,39,90,.433,27,53,.509,12,37,.324,20,23,.870,110,39,85,.459,26,46,.565,13,39,.333,24,35,.686,115
1283,2022-01-16,DEN,,UTA,L 102-125,240,42,95,.442,31,52,.596,11,43,.256,7,8,.875,102,44,84,.524,29,45,.644,15,39,.385,22,29,.759,125
1284,2022-01-16,UTA,@,DEN,W 125-102,240,44,84,.524,29,45,.644,15,39,.385,22,29,.759,125,42,95,.442,31,52,.596,11,43,.256,7,8,.875,102
1285,2022-01-16,DET,,PHO,L 108-135,240,38,82,.463,29,57,.509,9,25,.360,23,34,.676,108,51,87,.586,40,60,.667,11,27,.407,22,30,.733,135
1286,2022-01-16,PHO,@,DET,W 135-108,240,51,87,.586,40,60,.667,11,27,.407,22,30,.733,135,38,82,.463,29,57,.509,9,25,.360,23,34,.676,108
1287,2022-01-16,GSW,@,MIN,L 99-119,240,32,82,.390,19,40,.475,13,42,.310,22,29,.759,99,45,91,.495,29,48,.604,16,43,.372,13,20,.650,119
1288,2022-01-16,MIN,,GSW,W 119-99,240,45,91,.495,29,48,.604,16,43,.372,13,20,.650,119,32,82,.390,19,40,.475,13,42,.310,22,29,.759,99
1289,2022-01-16,HOU,@,SAC,W 118-112,240,41,76,.539,25,36,.694,16,40,.400,20,24,.833,118,41,91,.451,29,53,.547,12,38,.316,18,24,.750,112
1290,2022-01-16,SAC,,HOU,L 112-118,240,41,91,.451,29,53,.547,12,38,.316,18,24,.750,112,41,76,.539,25,36,.694,16,40,.400,20,24,.833,118
1291,2022-01-17,ATL,,MIL,W 121-114,240,38,86,.442,23,50,.460,15,36,.417,30,32,.938,121,39,88,.443,23,50,.460,16,38,.421,20,24,.833,114
1292,2022-01-17,MIL,@,ATL,L 114-121,240,39,88,.443,23,50,.460,16,38,.421,20,24,.833,114,38,86,.442,23,50,.460,15,36,.417,30,32,.938,121
1293,2022-01-17,BOS,,NOP,W 104-92,240,38,80,.475,28,48,.583,10,32,.313,18,20,.900,104,36,87,.414,27,57,.474,9,30,.300,11,18,.611,92
1294,2022-01-17,NOP,@,BOS,L 92-104,240,36,87,.414,27,57,.474,9,30,.300,11,18,.611,92,38,80,.475,28,48,.583,10,32,.313,18,20,.900,104
1295,2022-01-17,BRK,@,CLE,L 107-114,240,41,83,.494,29,53,.547,12,30,.400,13,18,.722,107,42,81,.519,31,49,.633,11,32,.344,19,21,.905,114
1296,2022-01-17,CLE,,BRK,W 114-107,240,42,81,.519,31,49,.633,11,32,.344,19,21,.905,114,41,83,.494,29,53,.547,12,30,.400,13,18,.722,107
1297,2022-01-17,DAL,,OKC,W 104-102,240,35,88,.398,23,51,.451,12,37,.324,22,28,.786,104,36,83,.434,25,48,.521,11,35,.314,19,24,.792,102
1298,2022-01-17,OKC,@,DAL,L 102-104,240,36,83,.434,25,48,.521,11,35,.314,19,24,.792,102,35,88,.398,23,51,.451,12,37,.324,22,28,.786,104
1299,2022-01-17,IND,@,LAC,L 133-139,240,50,97,.515,37,64,.578,13,33,.394,20,23,.870,133,45,82,.549,27,46,.587,18,36,.500,31,36,.861,139
1300,2022-01-17,LAC,,IND,W 139-133,240,45,82,.549,27,46,.587,18,36,.500,31,36,.861,139,50,97,.515,37,64,.578,13,33,.394,20,23,.870,133
1301,2022-01-17,LAL,,UTA,W 101-95,240,38,86,.442,27,49,.551,11,37,.297,14,23,.609,101,31,83,.373,19,37,.514,12,46,.261,21,24,.875,95
1302,2022-01-17,UTA,@,LAL,L 95-101,240,31,83,.373,19,37,.514,12,46,.261,21,24,.875,95,38,86,.442,27,49,.551,11,37,.297,14,23,.609,101
1303,2022-01-17,CHI,@,MEM,L 106-119,240,40,92,.435,27,61,.443,13,31,.419,13,15,.867,106,47,92,.511,37,67,.552,10,25,.400,15,20,.750,119
1304,2022-01-17,MEM,,CHI,W 119-106,240,47,92,.511,37,67,.552,10,25,.400,15,20,.750,119,40,92,.435,27,61,.443,13,31,.419,13,15,.867,106
1305,2022-01-17,MIA,,TOR,W 104-99,240,38,83,.458,29,59,.492,9,24,.375,19,22,.864,104,37,90,.411,24,54,.444,13,36,.361,12,17,.706,99
1306,2022-01-17,TOR,@,MIA,L 99-104,240,37,90,.411,24,54,.444,13,36,.361,12,17,.706,99,38,83,.458,29,59,.492,9,24,.375,19,22,.864,104
1307,2022-01-17,CHO,@,NYK,W 97-87,240,36,86,.419,22,47,.468,14,39,.359,11,17,.647,97,32,80,.400,20,46,.435,12,34,.353,11,21,.524,87
1308,2022-01-17,NYK,,CHO,L 87-97,240,32,80,.400,20,46,.435,12,34,.353,11,21,.524,87,36,86,.419,22,47,.468,14,39,.359,11,17,.647,97
1309,2022-01-17,ORL,,POR,L 88-98,240,34,90,.378,26,58,.448,8,32,.250,12,20,.600,88,37,90,.411,30,56,.536,7,34,.206,17,18,.944,98
1310,2022-01-17,POR,@,ORL,W 98-88,240,37,90,.411,30,56,.536,7,34,.206,17,18,.944,98,34,90,.378,26,58,.448,8,32,.250,12,20,.600,88
1311,2022-01-17,PHO,@,SAS,W 121-107,240,49,95,.516,40,63,.635,9,32,.281,14,20,.700,121,41,92,.446,32,62,.516,9,30,.300,16,22,.727,107
1312,2022-01-17,SAS,,PHO,L 107-121,240,41,92,.446,32,62,.516,9,30,.300,16,22,.727,107,49,95,.516,40,63,.635,9,32,.281,14,20,.700,121
1313,2022-01-17,PHI,@,WAS,L 98-117,240,35,86,.407,28,60,.467,7,26,.269,21,25,.840,98,42,87,.483,33,57,.579,9,30,.300,24,32,.750,117
1314,2022-01-17,WAS,,PHI,W 117-98,240,42,87,.483,33,57,.579,9,30,.300,24,32,.750,117,35,86,.407,28,60,.467,7,26,.269,21,25,.840,98
1315,2022-01-18,DET,@,GSW,L 86-102,240,30,85,.353,21,51,.412,9,34,.265,17,24,.708,86,34,83,.410,20,41,.488,14,42,.333,20,27,.741,102
1316,2022-01-18,GSW,,DET,W 102-86,240,34,83,.410,20,41,.488,14,42,.333,20,27,.741,102,30,85,.353,21,51,.412,9,34,.265,17,24,.708,86
1317,2022-01-18,MIN,@,NYK,W 112-110,240,35,81,.432,22,40,.550,13,41,.317,29,38,.763,112,37,80,.463,25,42,.595,12,38,.316,24,33,.727,110
1318,2022-01-18,NYK,,MIN,L 110-112,240,37,80,.463,25,42,.595,12,38,.316,24,33,.727,110,35,81,.432,22,40,.550,13,41,.317,29,38,.763,112
1319,2022-01-19,ATL,,MIN,W 134-122,240,45,86,.523,30,48,.625,15,38,.395,29,33,.879,134,42,97,.433,25,51,.490,17,46,.370,21,29,.724,122
1320,2022-01-19,MIN,@,ATL,L 122-134,240,42,97,.433,25,51,.490,17,46,.370,21,29,.724,122,45,86,.523,30,48,.625,15,38,.395,29,33,.879,134
1321,2022-01-19,BOS,,CHO,L 102-111,240,39,90,.433,25,44,.568,14,46,.304,10,13,.769,102,42,86,.488,26,47,.553,16,39,.410,11,15,.733,111
1322,2022-01-19,CHO,@,BOS,W 111-102,240,42,86,.488,26,47,.553,16,39,.410,11,15,.733,111,39,90,.433,25,44,.568,14,46,.304,10,13,.769,102
1323,2022-01-19,CHI,,CLE,W 117-104,240,47,86,.547,37,64,.578,10,22,.455,13,18,.722,117,40,77,.519,31,50,.620,9,27,.333,15,22,.682,104
1324,2022-01-19,CLE,@,CHI,L 104-117,240,40,77,.519,31,50,.620,9,27,.333,15,22,.682,104,47,86,.547,37,64,.578,10,22,.455,13,18,.722,117
1325,2022-01-19,DAL,,TOR,W 102-98,240,37,76,.487,28,43,.651,9,33,.273,19,20,.950,102,35,91,.385,27,59,.458,8,32,.250,20,25,.800,98
1326,2022-01-19,TOR,@,DAL,L 98-102,240,35,91,.385,27,59,.458,8,32,.250,20,25,.800,98,37,76,.487,28,43,.651,9,33,.273,19,20,.950,102
1327,2022-01-19,DEN,,LAC,W 130-128 (OT),265,48,98,.490,35,60,.583,13,38,.342,21,25,.840,130,52,97,.536,37,58,.638,15,39,.385,9,12,.750,128
1328,2022-01-19,LAC,@,DEN,L 128-130 (OT),265,52,97,.536,37,58,.638,15,39,.385,9,12,.750,128,48,98,.490,35,60,.583,13,38,.342,21,25,.840,130
1329,2022-01-19,IND,@,LAL,W 111-104,240,44,90,.489,33,60,.550,11,30,.367,12,15,.800,111,40,90,.444,29,56,.518,11,34,.324,13,18,.722,104
1330,2022-01-19,LAL,,IND,L 104-111,240,40,90,.444,29,56,.518,11,34,.324,13,18,.722,104,44,90,.489,33,60,.550,11,30,.367,12,15,.800,111
1331,2022-01-19,MIA,,POR,W 104-92,240,37,80,.463,25,45,.556,12,35,.343,18,25,.720,104,33,81,.407,19,35,.543,14,46,.304,12,16,.750,92
1332,2022-01-19,POR,@,MIA,L 92-104,240,33,81,.407,19,35,.543,14,46,.304,12,16,.750,92,37,80,.463,25,45,.556,12,35,.343,18,25,.720,104
1333,2022-01-19,MEM,@,MIL,L 114-126,240,44,106,.415,35,66,.530,9,40,.225,17,25,.680,114,46,97,.474,33,60,.550,13,37,.351,21,22,.955,126
1334,2022-01-19,MIL,,MEM,W 126-114,240,46,97,.474,33,60,.550,13,37,.351,21,22,.955,126,44,106,.415,35,66,.530,9,40,.225,17,25,.680,114
1335,2022-01-19,ORL,@,PHI,L 110-123,240,40,90,.444,22,55,.400,18,35,.514,12,16,.750,110,45,83,.542,35,55,.636,10,28,.357,23,27,.852,123
1336,2022-01-19,PHI,,ORL,W 123-110,240,45,83,.542,35,55,.636,10,28,.357,23,27,.852,123,40,90,.444,22,55,.400,18,35,.514,12,16,.750,110
1337,2022-01-19,DET,@,SAC,W 133-131,240,46,91,.505,31,55,.564,15,36,.417,26,30,.867,133,44,84,.524,32,57,.561,12,27,.444,31,44,.705,131
1338,2022-01-19,SAC,,DET,L 131-133,240,44,84,.524,32,57,.561,12,27,.444,31,44,.705,131,46,91,.505,31,55,.564,15,36,.417,26,30,.867,133
1339,2022-01-19,OKC,@,SAS,L 96-118,240,38,98,.388,30,67,.448,8,31,.258,12,15,.800,96,47,96,.490,32,56,.571,15,40,.375,9,14,.643,118
1340,2022-01-19,SAS,,OKC,W 118-96,240,47,96,.490,32,56,.571,15,40,.375,9,14,.643,118,38,98,.388,30,67,.448,8,31,.258,12,15,.800,96
1341,2022-01-19,HOU,@,UTA,W 116-111,240,41,96,.427,19,51,.373,22,45,.489,12,17,.706,116,42,89,.472,32,51,.627,10,38,.263,17,20,.850,111
1342,2022-01-19,UTA,,HOU,L 111-116,240,42,89,.472,32,51,.627,10,38,.263,17,20,.850,111,41,96,.427,19,51,.373,22,45,.489,12,17,.706,116
1343,2022-01-19,BRK,@,WAS,W 119-118,240,47,89,.528,39,64,.609,8,25,.320,17,20,.850,119,41,86,.477,31,57,.544,10,29,.345,26,32,.813,118
1344,2022-01-19,WAS,,BRK,L 118-119,240,41,86,.477,31,57,.544,10,29,.345,26,32,.813,118,47,89,.528,39,64,.609,8,25,.320,17,20,.850,119
1345,2022-01-20,DAL,,PHO,L 101-109,240,37,85,.435,26,48,.542,11,37,.297,16,20,.800,101,39,86,.453,31,50,.620,8,36,.222,23,25,.920,109
1346,2022-01-20,PHO,@,DAL,W 109-101,240,39,86,.453,31,50,.620,8,36,.222,23,25,.920,109,37,85,.435,26,48,.542,11,37,.297,16,20,.800,101
1347,2022-01-20,GSW,,IND,L 117-121 (OT),265,42,94,.447,33,52,.635,9,42,.214,24,29,.828,117,41,95,.432,26,60,.433,15,35,.429,24,34,.706,121
1348,2022-01-20,IND,@,GSW,W 121-117 (OT),265,41,95,.432,26,60,.433,15,35,.429,24,34,.706,121,42,94,.447,33,52,.635,9,42,.214,24,29,.828,117
1349,2022-01-20,NOP,@,NYK,W 102-91,240,38,76,.500,27,48,.563,11,28,.393,15,22,.682,102,29,77,.377,20,39,.513,9,38,.237,24,36,.667,91
1350,2022-01-20,NYK,,NOP,L 91-102,240,29,77,.377,20,39,.513,9,38,.237,24,36,.667,91,38,76,.500,27,48,.563,11,28,.393,15,22,.682,102
1351,2022-01-21,ATL,,MIA,W 110-108,240,38,68,.559,24,35,.686,14,33,.424,20,24,.833,110,41,85,.482,26,45,.578,15,40,.375,11,12,.917,108
1352,2022-01-21,MIA,@,ATL,L 108-110,240,41,85,.482,26,45,.578,15,40,.375,11,12,.917,108,38,68,.559,24,35,.686,14,33,.424,20,24,.833,110
1353,2022-01-21,BOS,,POR,L 105-109,240,37,82,.451,26,45,.578,11,37,.297,20,23,.870,105,36,76,.474,20,43,.465,16,33,.485,21,30,.700,109
1354,2022-01-21,POR,@,BOS,W 109-105,240,36,76,.474,20,43,.465,16,33,.485,21,30,.700,109,37,82,.451,26,45,.578,11,37,.297,20,23,.870,105
1355,2022-01-21,CHO,,OKC,W 121-98,240,45,99,.455,28,50,.560,17,49,.347,14,20,.700,121,37,98,.378,25,54,.463,12,44,.273,12,15,.800,98
1356,2022-01-21,OKC,@,CHO,L 98-121,240,37,98,.378,25,54,.463,12,44,.273,12,15,.800,98,45,99,.455,28,50,.560,17,49,.347,14,20,.700,121
1357,2022-01-21,DEN,,MEM,L 118-122,240,43,91,.473,30,59,.508,13,32,.406,19,23,.826,118,43,82,.524,32,57,.561,11,25,.440,25,40,.625,122
1358,2022-01-21,MEM,@,DEN,W 122-118,240,43,82,.524,32,57,.561,11,25,.440,25,40,.625,122,43,91,.473,30,59,.508,13,32,.406,19,23,.826,118
1359,2022-01-21,GSW,,HOU,W 105-103,240,39,81,.481,29,51,.569,10,30,.333,17,22,.773,105,38,89,.427,28,54,.519,10,35,.286,17,20,.850,103
1360,2022-01-21,HOU,@,GSW,L 103-105,240,38,89,.427,28,54,.519,10,35,.286,17,20,.850,103,39,81,.481,29,51,.569,10,30,.333,17,22,.773,105
1361,2022-01-21,CHI,@,MIL,L 90-94,240,31,85,.365,24,47,.511,7,38,.184,21,24,.875,90,34,88,.386,28,57,.491,6,31,.194,20,28,.714,94
1362,2022-01-21,MIL,,CHI,W 94-90,240,34,88,.386,28,57,.491,6,31,.194,20,28,.714,94,31,85,.365,24,47,.511,7,38,.184,21,24,.875,90
1363,2022-01-21,LAL,@,ORL,W 116-105,240,42,85,.494,29,55,.527,13,30,.433,19,23,.826,116,36,81,.444,25,41,.610,11,40,.275,22,29,.759,105
1364,2022-01-21,ORL,,LAL,L 105-116,240,36,81,.444,25,41,.610,11,40,.275,22,29,.759,105,42,85,.494,29,55,.527,13,30,.433,19,23,.826,116
1365,2022-01-21,LAC,@,PHI,W 102-101,240,40,87,.460,29,55,.527,11,32,.344,11,15,.733,102,38,91,.418,28,63,.444,10,28,.357,15,21,.714,101
1366,2022-01-21,PHI,,LAC,L 101-102,240,38,91,.418,28,63,.444,10,28,.357,15,21,.714,101,40,87,.460,29,55,.527,11,32,.344,11,15,.733,102
1367,2022-01-21,BRK,@,SAS,W 117-102,240,48,100,.480,39,75,.520,9,25,.360,12,12,1.000,117,37,95,.389,29,66,.439,8,29,.276,20,24,.833,102
1368,2022-01-21,SAS,,BRK,L 102-117,240,37,95,.389,29,66,.439,8,29,.276,20,24,.833,102,48,100,.480,39,75,.520,9,25,.360,12,12,1.000,117
1369,2022-01-21,DET,@,UTA,L 101-111,240,38,87,.437,25,55,.455,13,32,.406,12,16,.750,101,36,79,.456,26,48,.542,10,31,.323,29,34,.853,111
1370,2022-01-21,UTA,,DET,W 111-101,240,36,79,.456,26,48,.542,10,31,.323,29,34,.853,111,38,87,.437,25,55,.455,13,32,.406,12,16,.750,101
1371,2022-01-21,TOR,@,WAS,W 109-105,240,42,90,.467,31,60,.517,11,30,.367,14,17,.824,109,43,85,.506,32,52,.615,11,33,.333,8,10,.800,105
1372,2022-01-21,WAS,,TOR,L 105-109,240,43,85,.506,32,52,.615,11,33,.333,8,10,.800,105,42,90,.467,31,60,.517,11,30,.367,14,17,.824,109
1373,2022-01-22,CLE,,OKC,W 94-87,240,35,76,.461,29,49,.592,6,27,.222,18,35,.514,94,33,85,.388,21,44,.477,12,41,.293,9,16,.563,87
1374,2022-01-22,OKC,@,CLE,L 87-94,240,33,85,.388,21,44,.477,12,41,.293,9,16,.563,87,35,76,.461,29,49,.592,6,27,.222,18,35,.514,94
1375,2022-01-22,MIL,,SAC,W 133-127,240,45,91,.495,24,49,.490,21,42,.500,22,25,.880,133,51,97,.526,36,60,.600,15,37,.405,10,16,.625,127
1376,2022-01-22,SAC,@,MIL,L 127-133,240,51,97,.526,36,60,.600,15,37,.405,10,16,.625,127,45,91,.495,24,49,.490,21,42,.500,22,25,.880,133
1377,2022-01-22,IND,@,PHO,L 103-113,240,37,84,.440,27,55,.491,10,29,.345,19,27,.704,103,47,96,.490,40,71,.563,7,25,.280,12,14,.857,113
1378,2022-01-22,PHO,,IND,W 113-103,240,47,96,.490,40,71,.563,7,25,.280,12,14,.857,113,37,84,.440,27,55,.491,10,29,.345,19,27,.704,103
1379,2022-01-23,ATL,@,CHO,W 113-91,240,40,88,.455,25,49,.510,15,39,.385,18,24,.750,113,34,87,.391,30,51,.588,4,36,.111,19,27,.704,91
1380,2022-01-23,CHO,,ATL,L 91-113,240,34,87,.391,30,51,.588,4,36,.111,19,27,.704,91,40,88,.455,25,49,.510,15,39,.385,18,24,.750,113
1381,2022-01-23,DAL,,MEM,W 104-91,240,36,74,.486,27,44,.614,9,30,.300,23,31,.742,104,37,99,.374,33,75,.440,4,24,.167,13,19,.684,91
1382,2022-01-23,MEM,@,DAL,L 91-104,240,37,99,.374,33,75,.440,4,24,.167,13,19,.684,91,36,74,.486,27,44,.614,9,30,.300,23,31,.742,104
1383,2022-01-23,DEN,,DET,W 117-111,240,44,85,.518,32,50,.640,12,35,.343,17,23,.739,117,42,75,.560,31,46,.674,11,29,.379,16,19,.842,111
1384,2022-01-23,DET,@,DEN,L 111-117,240,42,75,.560,31,46,.674,11,29,.379,16,19,.842,111,44,85,.518,32,50,.640,12,35,.343,17,23,.739,117
1385,2022-01-23,GSW,,UTA,W 94-92,240,36,83,.434,23,41,.561,13,42,.310,9,10,.900,94,31,81,.383,20,46,.435,11,35,.314,19,23,.826,92
1386,2022-01-23,UTA,@,GSW,L 92-94,240,31,81,.383,20,46,.435,11,35,.314,19,23,.826,92,36,83,.434,23,41,.561,13,42,.310,9,10,.900,94
1387,2022-01-23,LAL,@,MIA,L 107-113,240,36,79,.456,25,39,.641,11,40,.275,24,30,.800,107,40,81,.494,25,48,.521,15,33,.455,18,20,.900,113
1388,2022-01-23,MIA,,LAL,W 113-107,240,40,81,.494,25,48,.521,15,33,.455,18,20,.900,113,36,79,.456,25,39,.641,11,40,.275,24,30,.800,107
1389,2022-01-23,BRK,@,MIN,L 125-136,240,48,95,.505,33,57,.579,15,38,.395,14,15,.933,125,48,92,.522,34,60,.567,14,32,.438,26,31,.839,136
1390,2022-01-23,MIN,,BRK,W 136-125,240,48,92,.522,34,60,.567,14,32,.438,26,31,.839,136,48,95,.505,33,57,.579,15,38,.395,14,15,.933,125
1391,2022-01-23,LAC,@,NYK,L 102-110,240,34,79,.430,20,38,.526,14,41,.341,20,30,.667,102,39,91,.429,23,55,.418,16,36,.444,16,19,.842,110
1392,2022-01-23,NYK,,LAC,W 110-102,240,39,91,.429,23,55,.418,16,36,.444,16,19,.842,110,34,79,.430,20,38,.526,14,41,.341,20,30,.667,102
1393,2022-01-23,CHI,@,ORL,L 95-114,240,33,76,.434,28,55,.509,5,21,.238,24,32,.750,95,42,80,.525,30,54,.556,12,26,.462,18,23,.783,114
1394,2022-01-23,ORL,,CHI,W 114-95,240,42,80,.525,30,54,.556,12,26,.462,18,23,.783,114,33,76,.434,28,55,.509,5,21,.238,24,32,.750,95
1395,2022-01-23,PHI,@,SAS,W 115-109,240,44,92,.478,37,76,.487,7,16,.438,20,23,.870,115,42,89,.472,32,59,.542,10,30,.333,15,22,.682,109
1396,2022-01-23,SAS,,PHI,L 109-115,240,42,89,.472,32,59,.542,10,30,.333,15,22,.682,109,44,92,.478,37,76,.487,7,16,.438,20,23,.870,115
1397,2022-01-23,POR,@,TOR,W 114-105,240,45,85,.529,27,53,.509,18,32,.563,6,13,.462,114,39,98,.398,21,44,.477,18,54,.333,9,14,.643,105
1398,2022-01-23,TOR,,POR,L 105-114,240,39,98,.398,21,44,.477,18,54,.333,9,14,.643,105,45,85,.529,27,53,.509,18,32,.563,6,13,.462,114
1399,2022-01-23,BOS,@,WAS,W 116-87,240,40,90,.444,21,51,.412,19,39,.487,17,21,.810,116,33,93,.355,25,59,.424,8,34,.235,13,16,.813,87
1400,2022-01-23,WAS,,BOS,L 87-116,240,33,93,.355,25,59,.424,8,34,.235,13,16,.813,87,40,90,.444,21,51,.412,19,39,.487,17,21,.810,116
1401,2022-01-24,CLE,,NYK,W 95-93,240,35,81,.432,22,45,.489,13,36,.361,12,20,.600,95,35,84,.417,23,46,.500,12,38,.316,11,21,.524,93
1402,2022-01-24,NYK,@,CLE,L 93-95,240,35,84,.417,23,46,.500,12,38,.316,11,21,.524,93,35,81,.432,22,45,.489,13,36,.361,12,20,.600,95
1403,2022-01-24,IND,@,NOP,L 113-117,240,38,87,.437,19,41,.463,19,46,.413,18,25,.720,113,41,88,.466,35,58,.603,6,30,.200,29,31,.935,117
1404,2022-01-24,NOP,,IND,W 117-113,240,41,88,.466,35,58,.603,6,30,.200,29,31,.935,117,38,87,.437,19,41,.463,19,46,.413,18,25,.720,113
1405,2022-01-24,CHI,@,OKC,W 111-110,240,41,89,.461,26,50,.520,15,39,.385,14,19,.737,111,38,92,.413,22,47,.468,16,45,.356,18,24,.750,110
1406,2022-01-24,OKC,,CHI,L 110-111,240,38,92,.413,22,47,.468,16,45,.356,18,24,.750,110,41,89,.461,26,50,.520,15,39,.385,14,19,.737,111
1407,2022-01-24,PHO,,UTA,W 115-109,240,47,99,.475,34,63,.540,13,36,.361,8,15,.533,115,40,81,.494,26,50,.520,14,31,.452,15,22,.682,109
1408,2022-01-24,UTA,@,PHO,L 109-115,240,40,81,.494,26,50,.520,14,31,.452,15,22,.682,109,47,99,.475,34,63,.540,13,36,.361,8,15,.533,115
1409,2022-01-25,BOS,,SAC,W 128-75,240,51,103,.495,31,58,.534,20,45,.444,6,7,.857,128,29,95,.305,23,62,.371,6,33,.182,11,15,.733,75
1410,2022-01-25,SAC,@,BOS,L 75-128,240,29,95,.305,23,62,.371,6,33,.182,11,15,.733,75,51,103,.495,31,58,.534,20,45,.444,6,7,.857,128
1411,2022-01-25,BRK,,LAL,L 96-106,240,37,88,.420,30,61,.492,7,27,.259,15,22,.682,96,42,89,.472,30,51,.588,12,38,.316,10,10,1.000,106
1412,2022-01-25,LAL,@,BRK,W 106-96,240,42,89,.472,30,51,.588,12,38,.316,10,10,1.000,106,37,88,.420,30,61,.492,7,27,.259,15,22,.682,96
1413,2022-01-25,DEN,@,DET,W 110-105,240,36,84,.429,25,52,.481,11,32,.344,27,31,.871,110,41,97,.423,29,61,.475,12,36,.333,11,14,.786,105
1414,2022-01-25,DET,,DEN,L 105-110,240,41,97,.423,29,61,.475,12,36,.333,11,14,.786,105,36,84,.429,25,52,.481,11,32,.344,27,31,.871,110
1415,2022-01-25,DAL,@,GSW,L 92-130,240,32,91,.352,22,51,.431,10,40,.250,18,18,1.000,92,49,92,.533,32,49,.653,17,43,.395,15,18,.833,130
1416,2022-01-25,GSW,,DAL,W 130-92,240,49,92,.533,32,49,.653,17,43,.395,15,18,.833,130,32,91,.352,22,51,.431,10,40,.250,18,18,1.000,92
1417,2022-01-25,HOU,,SAS,L 104-134,240,39,95,.411,30,61,.492,9,34,.265,17,25,.680,104,58,101,.574,46,69,.667,12,32,.375,6,6,1.000,134
1418,2022-01-25,SAS,@,HOU,W 134-104,240,58,101,.574,46,69,.667,12,32,.375,6,6,1.000,134,39,95,.411,30,61,.492,9,34,.265,17,25,.680,104
1419,2022-01-25,NOP,@,PHI,L 107-117,240,40,83,.482,31,61,.508,9,22,.409,18,26,.692,107,39,84,.464,29,53,.547,10,31,.323,29,31,.935,117
1420,2022-01-25,PHI,,NOP,W 117-107,240,39,84,.464,29,53,.547,10,31,.323,29,31,.935,117,40,83,.482,31,61,.508,9,22,.409,18,26,.692,107
1421,2022-01-25,MIN,@,POR,W 109-107,240,36,82,.439,22,39,.564,14,43,.326,23,31,.742,109,37,94,.394,21,53,.396,16,41,.390,17,20,.850,107
1422,2022-01-25,POR,,MIN,L 107-109,240,37,94,.394,21,53,.396,16,41,.390,17,20,.850,107,36,82,.439,22,39,.564,14,43,.326,23,31,.742,109
1423,2022-01-25,CHO,@,TOR,L 113-125,240,40,82,.488,30,51,.588,10,31,.323,23,32,.719,113,43,82,.524,27,48,.563,16,34,.471,23,29,.793,125
1424,2022-01-25,TOR,,CHO,W 125-113,240,43,82,.524,27,48,.563,16,34,.471,23,29,.793,125,40,82,.488,30,51,.588,10,31,.323,23,32,.719,113
1425,2022-01-25,LAC,@,WAS,W 116-115,240,39,94,.415,28,65,.431,11,29,.379,27,31,.871,116,37,80,.463,28,53,.528,9,27,.333,32,40,.800,115
1426,2022-01-25,WAS,,LAC,L 115-116,240,37,80,.463,28,53,.528,9,27,.333,32,40,.800,115,39,94,.415,28,65,.431,11,29,.379,27,31,.871,116

